word,Nb_char (C_w),Freq (F_w),Nb_scan_block (S_w_b),Nb_scan_key (S_w_k),Nb_scan (S_w),Nb_act_block,Nb_act_key,Nb_act,S_w_b x F_w,S_w_k x F_w,S_w x F_w,C_w x F_w,,,
the ,4,189,8,5,13,4,4,8,1512,945,2457,756,,,
a ,2,107,2,4,6,2,2,4,214,428,642,214,,16850,16850
is ,3,85,6,6,12,3,3,6,510,510,1020,255,,20352,
to ,3,56,5,4,9,3,3,6,280,224,504,168,,,
of ,3,54,6,6,12,3,3,6,324,324,648,162,,"2,00135162532946","2,34020409542475"
you ,4,49,7,13,20,4,4,8,343,637,980,196,,,
are ,4,36,4,10,14,4,4,8,144,360,504,144,,,
in ,3,34,6,5,11,3,3,6,204,170,374,102,,,
for ,4,27,7,10,17,4,4,8,189,270,459,108,,,
i ,2,26,3,4,7,2,2,4,78,104,182,52,,,
very ,5,24,7,18,25,5,5,10,168,432,600,120,,,
my ,3,23,9,6,15,3,3,6,207,138,345,69,,,
your ,5,22,8,17,25,5,5,10,176,374,550,110,,,
this ,5,21,12,8,20,5,5,10,252,168,420,105,,,
and ,4,20,6,10,16,4,4,8,120,200,320,80,,,
do ,3,20,4,8,12,3,3,6,80,160,240,60,,,
be ,3,19,8,4,12,3,3,6,152,76,228,57,,,
not ,4,18,8,5,13,4,4,8,144,90,234,72,,,
good ,5,17,8,15,23,5,5,10,136,255,391,85,,,
on ,3,17,6,4,10,3,3,6,102,68,170,51,,,
with ,5,17,14,8,22,5,5,10,238,136,374,85,,,
that ,5,16,10,7,17,5,5,10,160,112,272,80,,,
will ,5,16,12,14,26,5,5,10,192,224,416,80,,,
too ,4,15,7,6,13,4,4,8,105,90,195,60,,,
we ,3,15,7,5,12,3,3,6,105,75,180,45,,,
an ,3,14,5,5,10,3,3,6,70,70,140,42,,,
was ,4,14,10,8,18,4,4,8,140,112,252,56,,,
all ,4,12,6,12,18,4,4,8,72,144,216,48,,,
he ,3,11,6,4,10,3,3,6,66,44,110,33,,,
it ,3,11,5,5,10,3,3,6,55,55,110,33,,,
must ,5,11,12,11,23,5,5,10,132,121,253,55,,,
out ,4,11,6,10,16,4,4,8,66,110,176,44,,,
our ,4,10,5,13,18,4,4,8,50,130,180,40,,,
at ,3,9,4,5,9,3,3,6,36,45,81,27,,,
can ,4,9,9,7,16,4,4,8,81,63,144,36,,,
get ,4,9,6,9,15,4,4,8,54,81,135,36,,,
never ,6,9,8,17,25,6,6,12,72,153,225,54,,,
one ,4,9,7,6,13,4,4,8,63,54,117,36,,,
has ,4,8,9,7,16,4,4,8,72,56,128,32,,,
like ,5,8,8,16,24,5,5,10,64,128,192,40,,,
what ,5,8,13,8,21,5,5,10,104,64,168,40,,,
have ,5,7,8,14,22,5,5,10,56,98,154,35,,,
water ,6,7,11,13,24,6,6,12,77,91,168,42,,,
about ,6,6,13,14,27,6,6,12,78,84,162,36,,,
by ,3,6,10,6,16,3,3,6,60,36,96,18,,,
come ,5,6,13,8,21,5,5,10,78,48,126,30,,,
go ,3,6,5,8,13,3,3,6,30,48,78,18,,,
if ,3,6,6,7,13,3,3,6,36,42,78,18,,,
just ,5,6,11,14,25,5,5,10,66,84,150,30,,,
make ,5,6,10,13,23,5,5,10,60,78,138,30,,,
much ,5,6,15,11,26,5,5,10,90,66,156,30,,,
play ,5,6,11,15,26,5,5,10,66,90,156,30,,,
time ,5,6,11,8,19,5,5,10,66,48,114,30,,,
up ,3,6,6,10,16,3,3,6,36,60,96,18,,,
way ,4,6,10,10,20,4,4,8,60,60,120,24,,,
work ,5,6,11,15,26,5,5,10,66,90,156,30,,,
bad ,4,5,9,10,19,4,4,8,45,50,95,20,,,
big ,4,5,11,10,21,4,4,8,55,50,105,20,,,
coffee ,7,5,15,15,30,7,7,14,75,75,150,35,,,
did ,4,5,5,14,19,4,4,8,25,70,95,20,,,
dog ,4,5,6,13,19,4,4,8,30,65,95,20,,,
expensive ,10,5,20,28,48,10,10,20,100,140,240,50,,,
from ,5,5,12,11,23,5,5,10,60,55,115,25,,,
high ,5,5,13,11,24,5,5,10,65,55,120,25,,,
house ,6,5,12,14,26,6,6,12,60,70,130,30,,,
lot ,4,5,7,8,15,4,4,8,35,40,75,20,,,
many ,5,5,13,10,23,5,5,10,65,50,115,25,,,
more ,5,5,10,10,20,5,5,10,50,50,100,25,,,
no ,3,5,6,4,10,3,3,6,30,20,50,15,,,
please ,7,5,13,17,30,7,7,14,65,85,150,35,,,
question ,9,5,20,21,41,9,9,18,100,105,205,45,,,
see ,4,5,6,7,13,4,4,8,30,35,65,20,,,
than ,5,5,11,7,18,5,5,10,55,35,90,25,,,
there ,6,5,10,11,21,6,6,12,50,55,105,30,,,
always ,7,4,16,19,35,7,7,14,64,76,140,28,,,
better ,7,4,14,12,26,7,7,14,56,48,104,28,,,
every ,6,4,8,20,28,6,6,12,32,80,112,24,,,
favorite ,9,4,14,26,40,9,9,18,56,104,160,36,,,
first ,6,4,12,14,26,6,6,12,48,56,104,24,,,
hard ,5,4,8,14,22,5,5,10,32,56,88,20,,,
her ,4,4,7,8,15,4,4,8,28,32,60,16,,,
home ,5,4,13,7,20,5,5,10,52,28,80,20,,,
important ,10,4,23,20,43,10,10,20,92,80,172,40,,,
keep ,5,4,9,14,23,5,5,10,36,56,92,20,,,
late ,5,4,7,11,18,5,5,10,28,44,72,20,,,
lie ,4,4,6,10,16,4,4,8,24,40,64,16,,,
me ,3,4,7,4,11,3,3,6,28,16,44,12,,,
nation ,7,4,14,12,26,7,7,14,56,48,104,28,,,
should ,7,4,14,21,35,7,7,14,56,84,140,28,,,
so ,3,4,6,5,11,3,3,6,24,20,44,12,,,
some ,5,4,12,8,20,5,5,10,48,32,80,20,,,
take ,5,4,7,13,20,5,5,10,28,52,80,20,,,
their ,6,4,11,12,23,6,6,12,44,48,92,24,,,
through ,8,4,17,21,38,8,8,16,68,84,152,32,,,
today ,6,4,10,16,26,6,6,12,40,64,104,24,,,
want ,5,4,12,8,20,5,5,10,48,32,80,20,,,
where ,6,4,13,12,25,6,6,12,52,48,100,24,,,
am ,3,3,7,5,12,3,3,6,21,15,36,9,,,
before ,7,3,15,15,30,7,7,14,45,45,90,21,,,
bone ,5,3,13,7,20,5,5,10,39,21,60,15,,,
but ,4,3,10,9,19,4,4,8,30,27,57,12,,,
cannot ,7,3,16,11,27,7,7,14,48,33,81,21,,,
complicated ,12,3,29,29,58,12,12,24,87,87,174,36,,,
day ,4,3,6,13,19,4,4,8,18,39,57,12,,,
deserve ,8,3,10,25,35,8,8,16,30,75,105,24,,,
difficult ,10,3,21,31,52,10,10,20,63,93,156,30,,,
does ,5,3,8,12,20,5,5,10,24,36,60,15,,,
drugs ,6,3,9,23,32,6,6,12,27,69,96,18,,,
effort ,7,3,13,16,29,7,7,14,39,48,87,21,,,
faster ,7,3,12,16,28,7,7,14,36,48,84,21,,,
fine ,5,3,10,10,20,5,5,10,30,30,60,15,,,
food ,5,3,9,13,22,5,5,10,27,39,66,15,,,
force ,6,3,12,14,26,6,6,12,36,42,78,18,,,
help ,5,3,12,11,23,5,5,10,36,33,69,15,,,
idea ,5,3,6,14,20,5,5,10,18,42,60,15,,,
jacket ,7,3,15,19,34,7,7,14,45,57,102,21,,,
leave ,6,3,7,19,26,6,6,12,21,57,78,18,,,
library ,8,3,17,24,41,8,8,16,51,72,123,24,,,
little ,7,3,12,16,28,7,7,14,36,48,84,21,,,
love ,5,3,7,16,23,5,5,10,21,48,69,15,,,
makes ,6,3,13,15,28,6,6,12,39,45,84,18,,,
midnight ,9,3,22,21,43,9,9,18,66,63,129,27,,,
month ,6,3,17,7,24,6,6,12,51,21,72,18,,,
most ,5,3,13,7,20,5,5,10,39,21,60,15,,,
movie ,6,3,12,16,28,6,6,12,36,48,84,18,,,
music ,6,3,16,15,31,6,6,12,48,45,93,18,,,
new ,4,3,10,6,16,4,4,8,30,18,48,12,,,
nothing ,8,3,19,15,34,8,8,16,57,45,102,24,,,
off ,4,3,9,9,18,4,4,8,27,27,54,12,,,
only ,5,3,11,12,23,5,5,10,33,36,69,15,,,
parking ,8,3,16,26,42,8,8,16,48,78,126,24,,,
questions ,10,3,23,23,46,10,10,20,69,69,138,30,,,
rain ,5,3,8,12,20,5,5,10,24,36,60,15,,,
sharp ,6,3,14,14,28,6,6,12,42,42,84,18,,,
silly ,6,3,13,18,31,6,6,12,39,54,93,18,,,
smart ,6,3,13,12,25,6,6,12,39,36,75,18,,,
takes ,6,3,10,15,25,6,6,12,30,45,75,18,,,
they ,5,3,11,9,20,5,5,10,33,27,60,15,,,
thing ,6,3,14,12,26,6,6,12,42,36,78,18,,,
three ,6,3,10,11,21,6,6,12,30,33,63,18,,,
took ,5,3,9,12,21,5,5,10,27,36,63,15,,,
traveling ,10,3,16,31,47,10,10,20,48,93,141,30,,,
two ,4,3,10,6,16,4,4,8,30,18,48,12,,,
us ,3,3,5,9,14,3,3,6,15,27,42,9,,,
walk ,5,3,11,16,27,5,5,10,33,48,81,15,,,
watch ,6,3,17,10,27,6,6,12,51,30,81,18,,,
watched ,8,3,19,17,36,8,8,16,57,51,108,24,,,
win ,4,3,11,7,18,4,4,8,33,21,54,12,,,
words ,6,3,13,16,29,6,6,12,39,48,87,18,,,
wrong ,6,3,14,15,29,6,6,12,42,45,87,18,,,
accident ,9,2,19,20,39,9,9,18,38,40,78,18,,,
agree ,6,2,7,17,24,6,6,12,14,34,48,12,,,
ask ,4,2,7,12,19,4,4,8,14,24,38,8,,,
asked ,6,2,9,19,28,6,6,12,18,38,56,12,,,
away ,5,2,11,13,24,5,5,10,22,26,48,10,,,
bank ,5,2,13,12,25,5,5,10,26,24,50,10,,,
beautiful ,10,2,20,30,50,10,10,20,40,60,100,20,,,
best ,5,2,13,7,20,5,5,10,26,14,40,10,,,
books ,6,2,16,14,30,6,6,12,32,28,60,12,,,
boring ,7,2,17,17,34,7,7,14,34,34,68,14,,,
bring ,6,2,15,15,30,6,6,12,30,30,60,12,,,
broken ,7,2,16,17,33,7,7,14,32,34,66,14,,,
bus ,4,2,11,10,21,4,4,8,22,20,42,8,,,
busy ,5,2,14,14,28,5,5,10,28,28,56,10,,,
camera ,7,2,14,16,30,7,7,14,28,32,60,14,,,
car ,4,2,7,10,17,4,4,8,14,20,34,8,,,
cards ,6,2,11,17,28,6,6,12,22,34,56,12,,,
care ,5,2,8,12,20,5,5,10,16,24,40,10,,,
carpet ,7,2,14,16,30,7,7,14,28,32,60,14,,,
cars ,5,2,10,12,22,5,5,10,20,24,44,10,,,
chocolate ,10,2,23,20,43,10,10,20,46,40,86,20,,,
coming ,7,2,19,15,34,7,7,14,38,30,68,14,,,
communicate ,12,2,31,25,56,12,12,24,62,50,112,24,,,
connected ,10,2,22,19,41,10,10,20,44,38,82,20,,,
cookies ,8,2,17,20,37,8,8,16,34,40,74,16,,,
country ,8,2,17,21,38,8,8,16,34,42,76,16,,,
court ,6,2,11,16,27,6,6,12,22,32,54,12,,,
cream ,6,2,13,13,26,6,6,12,26,26,52,12,,,
crime ,6,2,14,13,27,6,6,12,28,26,54,12,,,
deserves ,9,2,13,27,40,9,9,18,26,54,80,18,,,
doctor ,7,2,13,17,30,7,7,14,26,34,60,14,,,
doors ,6,2,10,16,26,6,6,12,20,32,52,12,,,
double ,7,2,14,21,35,7,7,14,28,42,70,14,,,
drink ,6,2,10,20,30,6,6,12,20,40,60,12,,,
drive ,6,2,7,22,29,6,6,12,14,44,58,12,,,
dry ,4,2,6,14,20,4,4,8,12,28,40,8,,,
east ,5,2,8,9,17,5,5,10,16,18,34,10,,,
else ,5,2,8,11,19,5,5,10,16,22,38,10,,,
enjoy ,6,2,14,14,28,6,6,12,28,28,56,12,,,
enough ,7,2,14,18,32,7,7,14,28,36,64,14,,,
entire ,7,2,11,14,25,7,7,14,22,28,50,14,,,
environment ,12,2,25,26,51,12,12,24,50,52,102,24,,,
everyone ,9,2,14,25,39,9,9,18,28,50,78,18,,,
exchange ,9,2,20,22,42,9,9,18,40,44,84,18,,,
exercise ,9,2,17,23,40,9,9,18,34,46,80,18,,,
experience ,11,2,22,27,49,11,11,22,44,54,98,22,,,
facts ,6,2,14,12,26,6,6,12,28,24,52,12,,,
fax ,4,2,8,12,20,4,4,8,16,24,40,8,,,
feel ,5,2,8,12,20,5,5,10,16,24,40,10,,,
find ,5,2,10,13,23,5,5,10,20,26,46,10,,,
fire ,5,2,8,13,21,5,5,10,16,26,42,10,,,
fit ,4,2,8,8,16,4,4,8,16,16,32,8,,,
five ,5,2,8,16,24,5,5,10,16,32,48,10,,,
found ,6,2,11,18,29,6,6,12,22,36,58,12,,,
four ,5,2,8,16,24,5,5,10,16,32,48,10,,,
fox ,4,2,9,11,20,4,4,8,18,22,40,8,,,
fuel ,5,2,8,16,24,5,5,10,16,32,48,10,,,
gas ,4,2,7,11,18,4,4,8,14,22,36,8,,,
gets ,5,2,9,11,20,5,5,10,18,22,40,10,,,
getting ,8,2,15,19,34,8,8,16,30,38,68,16,,,
glasses ,8,2,16,21,37,8,8,16,32,42,74,16,,,
gun ,4,2,7,13,20,4,4,8,14,26,40,8,,,
had ,4,2,7,10,17,4,4,8,14,20,34,8,,,
hair ,5,2,9,12,21,5,5,10,18,24,42,10,,,
hardest ,8,2,14,19,33,8,8,16,28,38,66,16,,,
head ,5,2,8,12,20,5,5,10,16,24,40,10,,,
his ,4,2,10,7,17,4,4,8,20,14,34,8,,,
immediately ,12,2,26,30,56,12,12,24,52,60,112,24,,,
information ,12,2,27,25,52,12,12,24,54,50,104,24,,,
job ,4,2,13,8,21,4,4,8,26,16,42,8,,,
join ,5,2,12,11,23,5,5,10,24,22,46,10,,,
jumping ,8,2,22,24,46,8,8,16,44,48,92,16,,,
know ,5,2,13,12,25,5,5,10,26,24,50,10,,,
largest ,8,2,13,22,35,8,8,16,26,44,70,16,,,
learn ,6,2,9,15,24,6,6,12,18,30,48,12,,,
levee ,6,2,7,18,25,6,6,12,14,36,50,12,,,
life ,5,2,9,13,22,5,5,10,18,26,44,10,,,
light ,6,2,13,15,28,6,6,12,26,30,56,12,,,
listen ,7,2,14,14,28,7,7,14,28,28,56,14,,,
locked ,7,2,13,22,35,7,7,14,26,44,70,14,,,
look ,5,2,9,15,24,5,5,10,18,30,48,10,,,
looks ,6,2,12,17,29,6,6,12,24,34,58,12,,,
loose ,6,2,11,13,24,6,6,12,22,26,48,12,,,
made ,5,2,9,12,21,5,5,10,18,24,42,10,,,
man ,4,2,10,6,16,4,4,8,20,12,32,8,,,
means ,6,2,14,10,24,6,6,12,28,20,48,12,,,
meet ,5,2,10,7,17,5,5,10,20,14,34,10,,,
meeting ,8,2,17,16,33,8,8,16,34,32,66,16,,,
mind ,5,2,12,11,23,5,5,10,24,22,46,10,,,
monkey ,7,2,17,17,34,7,7,14,34,34,68,14,,,
monthly ,8,2,22,15,37,8,8,16,44,30,74,16,,,
need ,5,2,7,11,18,5,5,10,14,22,36,10,,,
needs ,6,2,10,13,23,6,6,12,20,26,46,12,,,
news ,5,2,13,8,21,5,5,10,26,16,42,10,,,
nose ,5,2,10,8,18,5,5,10,20,16,36,10,,,
objects ,8,2,23,15,38,8,8,16,46,30,76,16,,,
or ,3,2,4,7,11,3,3,6,8,14,22,6,,,
organization ,13,2,28,31,59,13,13,26,56,62,118,26,,,
over ,5,2,6,16,22,5,5,10,12,32,44,10,,,
people ,7,2,15,17,32,7,7,14,30,34,64,14,,,
place ,6,2,13,15,28,6,6,12,26,30,56,12,,,
put ,4,2,8,11,19,4,4,8,16,22,38,8,,,
quick ,6,2,15,21,36,6,6,12,30,42,72,12,,,
reading ,8,2,12,24,36,8,8,16,24,48,72,16,,,
red ,4,2,4,12,16,4,4,8,8,24,32,8,,,
registered ,11,2,16,31,47,11,11,22,32,62,94,22,,,
response ,9,2,19,19,38,9,9,18,38,38,76,18,,,
right ,6,2,12,15,27,6,6,12,24,30,54,12,,,
rises ,6,2,11,14,25,6,6,12,22,28,50,12,,,
risk ,5,2,9,16,25,5,5,10,18,32,50,10,,,
round ,6,2,9,19,28,6,6,12,18,38,56,12,,,
run ,4,2,6,12,18,4,4,8,12,24,36,8,,,
say ,4,2,8,10,18,4,4,8,16,20,36,8,,,
sent ,5,2,10,7,17,5,5,10,20,14,34,10,,,
seven ,6,2,10,15,25,6,6,12,20,30,50,12,,,
she ,4,2,9,6,15,4,4,8,18,12,30,8,,,
shop ,5,2,14,9,23,5,5,10,28,18,46,10,,,
shopping ,9,2,25,21,46,9,9,18,50,42,92,18,,,
six ,4,2,9,11,20,4,4,8,18,22,40,8,,,
small ,6,2,14,15,29,6,6,12,28,30,58,12,,,
someone ,8,2,18,13,31,8,8,16,36,26,62,16,,,
speed ,6,2,11,15,26,6,6,12,22,30,52,12,,,
spill ,6,2,14,17,31,6,6,12,28,34,62,12,,,
sprawling ,10,2,24,28,52,10,10,20,48,56,104,20,,,
staying ,8,2,17,20,37,8,8,16,34,40,74,16,,,
still ,6,2,12,15,27,6,6,12,24,30,54,12,,,
strike ,7,2,12,19,31,7,7,14,24,38,62,14,,,
stuck ,6,2,13,18,31,6,6,12,26,36,62,12,,,
subject ,8,2,22,19,41,8,8,16,44,38,82,16,,,
system ,7,2,18,13,31,7,7,14,36,26,62,14,,,
team ,5,2,10,8,18,5,5,10,20,16,36,10,,,
ten ,4,2,7,5,12,4,4,8,14,10,24,8,,,
these ,6,2,12,9,21,6,6,12,24,18,42,12,,,
things ,7,2,17,14,31,7,7,14,34,28,62,14,,,
think ,6,2,14,13,27,6,6,12,28,26,54,12,,,
tickets ,8,2,17,18,35,8,8,16,34,36,70,16,,,
tie ,4,2,6,7,13,4,4,8,12,14,26,8,,,
times ,6,2,14,10,24,6,6,12,28,20,48,12,,,
tomorrow ,9,2,21,19,40,9,9,18,42,38,80,18,,,
tonight ,8,2,18,15,33,8,8,16,36,30,66,16,,,
try ,4,2,7,10,17,4,4,8,14,20,34,8,,,
visit ,6,2,11,17,28,6,6,12,22,34,56,12,,,
wants ,6,2,15,10,25,6,6,12,30,20,50,12,,,
warm ,5,2,13,11,24,5,5,10,26,22,48,10,,,
wearing ,8,2,16,21,37,8,8,16,32,42,74,16,,,
wears ,6,2,12,14,26,6,6,12,24,28,52,12,,,
weekend ,8,2,15,21,36,8,8,16,30,42,72,16,,,
were ,5,2,9,11,20,5,5,10,18,22,40,10,,,
when ,5,2,14,7,21,5,5,10,28,14,42,10,,,
wind ,5,2,12,12,24,5,5,10,24,24,48,10,,,
window ,7,2,19,16,35,7,7,14,38,32,70,14,,,
without ,8,2,19,17,36,8,8,16,38,34,72,16,,,
world ,6,2,12,18,30,6,6,12,24,36,60,12,,,
would ,6,2,12,20,32,6,6,12,24,40,64,12,,,
yard ,5,2,7,17,24,5,5,10,14,34,48,10,,,
zero ,5,2,11,11,22,5,5,10,22,22,44,10,,,
abandoned ,10,1,20,24,44,10,10,20,20,24,44,10,,,
aboard ,7,1,13,19,32,7,7,14,13,19,32,7,,,
accept ,7,1,17,14,31,7,7,14,17,14,31,7,,,
acceptance ,11,1,26,22,48,11,11,22,26,22,48,11,,,
accompanied ,12,1,29,28,57,12,12,24,29,28,57,12,,,
according ,10,1,21,28,49,10,10,20,21,28,49,10,,,
account ,8,1,18,18,36,8,8,16,18,18,36,8,,,
acutely ,8,1,15,23,38,8,8,16,15,23,38,8,,,
addition ,9,1,15,24,39,9,9,18,15,24,39,9,,,
adult ,6,1,8,20,28,6,6,12,8,20,28,6,,,
advance ,8,1,13,24,37,8,8,16,13,24,37,8,,,
afraid ,7,1,10,22,32,7,7,14,10,22,32,7,,,
after ,6,1,9,14,23,6,6,12,9,14,23,6,,,
again ,6,1,10,16,26,6,6,12,10,16,26,6,,,
ages ,5,1,8,13,21,5,5,10,8,13,21,5,,,
agreement ,10,1,18,22,40,10,10,20,18,22,40,10,,,
ahead ,6,1,9,15,24,6,6,12,9,15,24,6,,,
airport ,8,1,14,21,35,8,8,16,14,21,35,8,,,
algorithm ,10,1,22,25,47,10,10,20,22,25,47,10,,,
allergic ,9,1,16,28,44,9,9,18,16,28,44,9,,,
alligator ,10,1,16,30,46,10,10,20,16,30,46,10,,,
allotted ,9,1,14,23,37,9,9,18,14,23,37,9,,,
almost ,7,1,16,14,30,7,7,14,16,14,30,7,,,
amazing ,8,1,21,19,40,8,8,16,21,19,40,8,,,
amount ,7,1,15,15,30,7,7,14,15,15,30,7,,,
animal ,7,1,15,16,31,7,7,14,15,16,31,7,,,
anniversary ,12,1,21,35,56,12,12,24,21,35,56,12,,,
announce ,9,1,19,19,38,9,9,18,19,19,38,9,,,
answered ,9,1,17,22,39,9,9,18,17,22,39,9,,,
any ,4,1,8,9,17,4,4,8,8,9,17,4,,,
anymore ,8,1,17,18,35,8,8,16,17,18,35,8,,,
anything ,9,1,21,20,41,9,9,18,21,20,41,9,,,
apartments ,11,1,24,22,46,11,11,22,24,22,46,11,,,
appears ,8,1,16,21,37,8,8,16,16,21,37,8,,,
apple ,6,1,13,16,29,6,6,12,13,16,29,6,,,
appointment ,12,1,30,22,52,12,12,24,30,22,52,12,,,
arguing ,8,1,13,28,41,8,8,16,13,28,41,8,,,
around ,7,1,10,22,32,7,7,14,10,22,32,7,,,
as ,3,1,5,6,11,3,3,6,5,6,11,3,,,
aspirations ,12,1,25,28,53,12,12,24,25,28,53,12,,,
assault ,8,1,14,22,36,8,8,16,14,22,36,8,,,
assignment ,11,1,26,22,48,11,11,22,26,22,48,11,,,
astonishment ,13,1,32,21,53,13,13,26,32,21,53,13,,,
ate ,4,1,5,7,12,4,4,8,5,7,12,4,,,
athletes ,9,1,17,17,34,9,9,18,17,17,34,9,,,
avoided ,8,1,10,28,38,8,8,16,10,28,38,8,,,
aware ,6,1,10,15,25,6,6,12,10,15,25,6,,,
back ,5,1,14,13,27,5,5,10,14,13,27,5,,,
baking ,7,1,17,20,37,7,7,14,17,20,37,7,,,
balance ,8,1,19,17,36,8,8,16,19,17,36,8,,,
ball ,5,1,12,13,25,5,5,10,12,13,25,5,,,
baloney ,8,1,19,18,37,8,8,16,19,18,37,8,,,
bare ,5,1,10,11,21,5,5,10,10,11,21,5,,,
baroque ,8,1,18,22,40,8,8,16,18,22,40,8,,,
barracks ,9,1,20,26,46,9,9,18,20,26,46,9,,,
bases ,6,1,15,11,26,6,6,12,15,11,26,6,,,
bath ,5,1,14,7,21,5,5,10,14,7,21,5,,,
bathroom ,9,1,24,16,40,9,9,18,24,16,40,9,,,
batman ,7,1,19,11,30,7,7,14,19,11,30,7,,,
battles ,8,1,18,15,33,8,8,16,18,15,33,8,,,
bears ,6,1,13,13,26,6,6,12,13,13,26,6,,,
been ,5,1,12,7,19,5,5,10,12,7,19,5,,,
beer ,5,1,10,10,20,5,5,10,10,10,20,5,,,
bees ,5,1,12,8,20,5,5,10,12,8,20,5,,,
beginning ,10,1,25,23,48,10,10,20,25,23,48,10,,,
behind ,7,1,18,14,32,7,7,14,18,14,32,7,,,
believe ,8,1,15,22,37,8,8,16,15,22,37,8,,,
benign ,7,1,18,14,32,7,7,14,18,14,32,7,,,
between ,8,1,20,12,32,8,8,16,20,12,32,8,,,
beware ,7,1,16,15,31,7,7,14,16,15,31,7,,,
biggest ,8,1,19,20,39,8,8,16,19,20,39,8,,,
bike ,5,1,12,13,25,5,5,10,12,13,25,5,,,
bill ,5,1,13,13,26,5,5,10,13,13,26,5,,,
bills ,6,1,16,15,31,6,6,12,16,15,31,6,,,
bird ,5,1,11,14,25,5,5,10,11,14,25,5,,,
birth ,6,1,16,11,27,6,6,12,16,11,27,6,,,
birthday ,9,1,21,23,44,9,9,18,21,23,44,9,,,
bite ,5,1,12,8,20,5,5,10,12,8,20,5,,,
bites ,6,1,15,10,25,6,6,12,15,10,25,6,,,
blast ,6,1,15,12,27,6,6,12,15,12,27,6,,,
blazed ,7,1,18,18,36,7,7,14,18,18,36,7,,,
blazing ,8,1,23,20,43,8,8,16,23,20,43,8,,,
blocked ,8,1,19,23,42,8,8,16,19,23,42,8,,,
bloodshed ,10,1,23,25,48,10,10,20,23,25,48,10,,,
blow ,5,1,16,10,26,5,5,10,16,10,26,5,,,
blues ,6,1,14,16,30,6,6,12,14,16,30,6,,,
borrower ,9,1,20,22,42,9,9,18,20,22,42,9,,,
boss ,5,1,15,8,23,5,5,10,15,8,23,5,,,
boys ,5,1,15,10,25,5,5,10,15,10,25,5,,,
break ,6,1,12,17,29,6,6,12,12,17,29,6,,,
breaks ,7,1,15,19,34,7,7,14,15,19,34,7,,,
breathing ,10,1,23,22,45,10,10,20,23,22,45,10,,,
broke ,6,1,13,16,29,6,6,12,13,16,29,6,,,
brown ,6,1,18,11,29,6,6,12,18,11,29,6,,,
browser ,8,1,20,18,38,8,8,16,20,18,38,8,,,
buckle ,7,1,17,22,39,7,7,14,17,22,39,7,,,
bullet ,7,1,15,19,34,7,7,14,15,19,34,7,,,
burglars ,9,1,18,30,48,9,9,18,18,30,48,9,,,
buried ,7,1,13,22,35,7,7,14,13,22,35,7,,,
business ,9,1,23,20,43,9,9,18,23,20,43,9,,,
bypass ,7,1,21,16,37,7,7,14,21,16,37,7,,,
cake ,5,1,9,14,23,5,5,10,9,14,23,5,,,
call ,5,1,10,14,24,5,5,10,10,14,24,5,,,
called ,7,1,12,21,33,7,7,14,12,21,33,7,,,
camping ,8,1,22,19,41,8,8,16,22,19,41,8,,,
canada ,7,1,12,18,30,7,7,14,12,18,30,7,,,
cancer ,7,1,15,15,30,7,7,14,15,15,30,7,,,
cape ,5,1,11,11,22,5,5,10,11,11,22,5,,,
capital ,8,1,17,20,37,8,8,16,17,20,37,8,,,
capitalist ,11,1,24,26,50,11,11,22,24,26,50,11,,,
card ,5,1,8,15,23,5,5,10,8,15,23,5,,,
careless ,9,1,17,22,39,9,9,18,17,22,39,9,,,
cares ,6,1,11,14,25,6,6,12,11,14,25,6,,,
cat ,4,1,8,7,15,4,4,8,8,7,15,4,,,
cells ,6,1,13,15,28,6,6,12,13,15,28,6,,,
century ,8,1,16,21,37,8,8,16,16,21,37,8,,,
challenged ,11,1,22,30,52,11,11,22,22,30,52,11,,,
chamber ,8,1,23,15,38,8,8,16,23,15,38,8,,,
chancellor ,11,1,25,26,51,11,11,22,25,26,51,11,,,
changed ,8,1,17,20,37,8,8,16,17,20,37,8,,,
checks ,7,1,19,16,35,7,7,14,19,16,35,7,,,
cheese ,7,1,15,12,27,7,7,14,15,12,27,7,,,
chemical ,9,1,24,19,43,9,9,18,24,19,43,9,,,
chemistry ,10,1,26,21,47,10,10,20,26,21,47,10,,,
chevy ,6,1,14,17,31,6,6,12,14,17,31,6,,,
child ,6,1,14,16,30,6,6,12,14,16,30,6,,,
children ,9,1,19,23,42,9,9,18,19,23,42,9,,,
chills ,7,1,18,17,35,7,7,14,18,17,35,7,,,
chlorine ,9,1,20,20,40,9,9,18,20,20,40,9,,,
circumstances ,14,1,35,32,67,14,14,28,35,32,67,14,,,
city ,5,1,12,11,23,5,5,10,12,11,23,5,,,
classical ,10,1,23,26,49,10,10,20,23,26,49,10,,,
claus ,6,1,12,18,30,6,6,12,12,18,30,6,,,
close ,6,1,13,13,26,6,6,12,13,13,26,6,,,
closed ,7,1,14,18,32,7,7,14,14,18,32,7,,,
coalition ,10,1,21,22,43,10,10,20,21,22,43,10,,,
cold ,5,1,10,14,24,5,5,10,10,14,24,5,,,
collapse ,9,1,20,23,43,9,9,18,20,23,43,9,,,
comment ,8,1,23,11,34,8,8,16,23,11,34,8,,,
committed ,10,1,25,19,44,10,10,20,25,19,44,10,,,
companies ,10,1,26,20,46,10,10,20,26,20,46,10,,,
complaints ,11,1,29,23,52,11,11,22,29,23,52,11,,,
complete ,9,1,22,18,40,9,9,18,22,18,40,9,,,
completely ,11,1,27,26,53,11,11,22,27,26,53,11,,,
concentrate ,12,1,25,22,47,12,12,24,25,22,47,12,,,
conferences ,12,1,27,24,51,12,12,24,27,24,51,12,,,
confidential ,13,1,27,31,58,13,13,26,27,31,58,13,,,
conscience ,11,1,28,20,48,11,11,22,28,20,48,11,,,
consequences ,13,1,32,28,60,13,13,26,32,28,60,13,,,
consideration ,14,1,28,32,60,14,14,28,28,32,60,14,,,
construction ,13,1,30,28,58,13,13,26,30,28,58,13,,,
contest ,8,1,18,12,30,8,8,16,18,12,30,8,,,
contrast ,9,1,19,17,36,9,9,18,19,17,36,9,,,
cooled ,7,1,13,18,31,7,7,14,13,18,31,7,,,
coronation ,11,1,23,22,45,11,11,22,23,22,45,11,,,
correct ,8,1,16,18,34,8,8,16,16,18,34,8,,,
correction ,11,1,23,24,47,11,11,22,23,24,47,11,,,
cottage ,8,1,15,17,32,8,8,16,15,17,32,8,,,
cotton ,7,1,16,10,26,7,7,14,16,10,26,7,,,
coupon ,7,1,17,17,34,7,7,14,17,17,34,7,,,
course ,7,1,13,19,32,7,7,14,13,19,32,7,,,
courts ,7,1,14,18,32,7,7,14,14,18,32,7,,,
cover ,6,1,10,18,28,6,6,12,10,18,28,6,,,
crowded ,8,1,16,23,39,8,8,16,16,23,39,8,,,
crown ,6,1,16,12,28,6,6,12,16,12,28,6,,,
cups ,5,1,13,14,27,5,5,10,13,14,27,5,,,
curve ,6,1,9,22,31,6,6,12,9,22,31,6,,,
custody ,8,1,17,23,40,8,8,16,17,23,40,8,,,
cut ,4,1,8,10,18,4,4,8,8,10,18,4,,,
daily ,6,1,10,20,30,6,6,12,10,20,30,6,,,
daring ,7,1,11,22,33,7,7,14,11,22,33,7,,,
dashing ,8,1,17,21,38,8,8,16,17,21,38,8,,,
date ,5,1,6,12,18,5,5,10,6,12,18,5,,,
daughters ,10,1,17,30,47,10,10,20,17,30,47,10,,,
decision ,9,1,19,21,40,9,9,18,19,21,40,9,,,
decisions ,10,1,22,23,45,10,10,20,22,23,45,10,,,
deed ,5,1,5,15,20,5,5,10,5,15,20,5,,,
delivery ,9,1,13,32,45,9,9,18,13,32,45,9,,,
denial ,7,1,11,19,30,7,7,14,11,19,30,7,,,
department ,11,1,22,24,46,11,11,22,22,24,46,11,,,
depot ,6,1,11,14,25,6,6,12,11,14,25,6,,,
desired ,8,1,11,24,35,8,8,16,11,24,35,8,,,
destruction ,12,1,23,30,53,12,12,24,23,30,53,12,,,
details ,8,1,13,21,34,8,8,16,13,21,34,8,,,
detector ,9,1,15,20,35,9,9,18,15,20,35,9,,,
dewdrop ,8,1,16,24,40,8,8,16,16,24,40,8,,,
diction ,8,1,17,18,35,8,8,16,17,18,35,8,,,
dine ,5,1,8,12,20,5,5,10,8,12,20,5,,,
dinosaurs ,10,1,18,29,47,10,10,20,18,29,47,10,,,
diplomacy ,10,1,25,28,53,10,10,20,25,28,53,10,,,
dipped ,7,1,14,22,36,7,7,14,14,22,36,7,,,
direction ,10,1,19,24,43,10,10,20,19,24,43,10,,,
disaster ,9,1,15,23,38,9,9,18,15,23,38,9,,,
discharged ,11,1,21,33,54,11,11,22,21,33,54,11,,,
discouraging ,13,1,25,42,67,13,13,26,25,42,67,13,,,
discovering ,12,1,23,37,60,12,12,24,23,37,60,12,,,
discreet ,9,1,16,22,38,9,9,18,16,22,38,9,,,
disgusting ,11,1,22,34,56,11,11,22,22,34,56,11,,,
disturbance ,12,1,26,31,57,12,12,24,26,31,57,12,,,
dolphins ,9,1,22,22,44,9,9,18,22,22,44,9,,,
door ,5,1,7,14,21,5,5,10,7,14,21,5,,,
dormitory ,10,1,20,27,47,10,10,20,20,27,47,10,,,
dow ,4,1,9,10,19,4,4,8,9,10,19,4,,,
down ,5,1,12,11,23,5,5,10,12,11,23,5,,,
dream ,6,1,10,16,26,6,6,12,10,16,26,6,,,
dreamers ,9,1,15,24,39,9,9,18,15,24,39,9,,,
dreams ,7,1,13,18,31,7,7,14,13,18,31,7,,,
dress ,6,1,10,16,26,6,6,12,10,16,26,6,,,
drivers ,8,1,11,28,39,8,8,16,11,28,39,8,,,
driveways ,10,1,19,33,52,10,10,20,19,33,52,10,,,
driving ,8,1,13,29,42,8,8,16,13,29,42,8,,,
drove ,6,1,7,21,28,6,6,12,7,21,28,6,,,
duck ,5,1,9,20,29,5,5,10,9,20,29,5,,,
due ,4,1,4,14,18,4,4,8,4,14,18,4,,,
each ,5,1,11,9,20,5,5,10,11,9,20,5,,,
early ,6,1,9,18,27,6,6,12,9,18,27,6,,,
earth ,6,1,10,12,22,6,6,12,10,12,22,6,,,
easy ,5,1,9,12,21,5,5,10,9,12,21,5,,,
eat ,4,1,5,7,12,4,4,8,5,7,12,4,,,
economy ,8,1,21,15,36,8,8,16,21,15,36,8,,,
edition ,8,1,14,18,32,8,8,16,14,18,32,8,,,
education ,10,1,18,26,44,10,10,20,18,26,44,10,,,
efforts ,8,1,16,18,34,8,8,16,16,18,34,8,,,
ego ,4,1,6,10,16,4,4,8,6,10,16,4,,,
eight ,6,1,12,13,25,6,6,12,12,13,25,6,,,
elections ,10,1,21,20,41,10,10,20,21,20,41,10,,,
electric ,9,1,18,21,39,9,9,18,18,21,39,9,,,
electrical ,11,1,21,28,49,11,11,22,21,28,49,11,,,
elephants ,10,1,22,20,42,10,10,20,22,20,42,10,,,
elevator ,9,1,12,26,38,9,9,18,12,26,38,9,,,
email ,6,1,12,14,26,6,6,12,12,14,26,6,,,
empire ,7,1,15,16,31,7,7,14,15,16,31,7,,,
employee ,9,1,20,21,41,9,9,18,20,21,41,9,,,
encouragement ,14,1,28,33,61,14,14,28,28,33,61,14,,,
end ,4,1,6,9,15,4,4,8,6,9,15,4,,,
engine ,7,1,13,15,28,7,7,14,13,15,28,7,,,
enlarged ,9,1,13,27,40,9,9,18,13,27,40,9,,,
enter ,6,1,9,11,20,6,6,12,9,11,20,6,,,
equation ,9,1,18,22,40,9,9,18,18,22,40,9,,,
etiquette ,10,1,18,22,40,10,10,20,18,22,40,10,,,
evening ,8,1,14,22,36,8,8,16,14,22,36,8,,,
eventually ,11,1,18,35,53,11,11,22,18,35,53,11,,,
ever ,5,1,5,16,21,5,5,10,5,16,21,5,,,
everybody ,10,1,20,32,52,10,10,20,20,32,52,10,,,
everyday ,9,1,13,32,45,9,9,18,13,32,45,9,,,
everywhere ,11,1,20,31,51,11,11,22,20,31,51,11,,,
exam ,5,1,11,12,23,5,5,10,11,12,23,5,,,
example ,8,1,18,21,39,8,8,16,18,21,39,8,,,
exasperation ,13,1,25,32,57,13,13,26,25,32,57,13,,,
exceed ,7,1,12,19,31,7,7,14,12,19,31,7,,,
excellent ,10,1,20,24,44,10,10,20,20,24,44,10,,,
excited ,8,1,15,21,36,8,8,16,15,21,36,8,,,
exciting ,9,1,20,23,43,9,9,18,20,23,43,9,,,
expectancy ,11,1,27,26,53,11,11,22,27,26,53,11,,,
expenses ,9,1,20,20,40,9,9,18,20,20,40,9,,,
explosion ,10,1,23,25,48,10,10,20,23,25,48,10,,,
express ,8,1,17,21,38,8,8,16,17,21,38,8,,,
extinct ,8,1,18,16,34,8,8,16,18,16,34,8,,,
extra ,6,1,9,16,25,6,6,12,9,16,25,6,,,
face ,5,1,10,11,21,5,5,10,10,11,21,5,,,
failure ,8,1,12,26,38,8,8,16,12,26,38,8,,,
fall ,5,1,9,15,24,5,5,10,9,15,24,5,,,
falling ,8,1,16,24,40,8,8,16,16,24,40,8,,,
fans ,5,1,11,10,21,5,5,10,11,10,21,5,,,
fast ,5,1,10,10,20,5,5,10,10,10,20,5,,,
favourite ,10,1,15,32,47,10,10,20,15,32,47,10,,,
february ,9,1,18,28,46,9,9,18,18,28,46,9,,,
feeling ,8,1,15,21,36,8,8,16,15,21,36,8,,,
fell ,5,1,9,14,23,5,5,10,9,14,23,5,,,
few ,4,1,10,8,18,4,4,8,10,8,18,4,,,
field ,6,1,10,18,28,6,6,12,10,18,28,6,,,
figure ,7,1,11,24,35,7,7,14,11,24,35,7,,,
file ,5,1,9,13,22,5,5,10,9,13,22,5,,,
finer ,6,1,11,14,25,6,6,12,11,14,25,6,,,
fingers ,8,1,16,21,37,8,8,16,16,21,37,8,,,
fish ,5,1,13,10,23,5,5,10,13,10,23,5,,,
flashing ,9,1,21,23,44,9,9,18,21,23,44,9,,,
flat ,5,1,9,12,21,5,5,10,9,12,21,5,,,
flavored ,9,1,13,31,44,9,9,18,13,31,44,9,,,
flying ,7,1,16,21,37,7,7,14,16,21,37,7,,,
fog ,4,1,8,11,19,4,4,8,8,11,19,4,,,
folds ,6,1,12,17,29,6,6,12,12,17,29,6,,,
follow ,7,1,17,18,35,7,7,14,17,18,35,7,,,
football ,9,1,21,21,42,9,9,18,21,21,42,9,,,
forest ,7,1,13,15,28,7,7,14,13,15,28,7,,,
forever ,8,1,11,25,36,8,8,16,11,25,36,8,,,
forward ,8,1,15,24,39,8,8,16,15,24,39,8,,,
fourth ,7,1,14,18,32,7,7,14,14,18,32,7,,,
free ,5,1,7,12,19,5,5,10,7,12,19,5,,,
frequently ,11,1,23,31,54,11,11,22,23,31,54,11,,,
freud ,6,1,8,21,29,6,6,12,8,21,29,6,,,
friend ,7,1,12,19,31,7,7,14,12,19,31,7,,,
friendly ,9,1,17,27,44,9,9,18,17,27,44,9,,,
front ,6,1,12,12,24,6,6,12,12,12,24,6,,,
fudge ,6,1,9,22,31,6,6,12,9,22,31,6,,,
full ,5,1,9,18,27,5,5,10,9,18,27,5,,,
fully ,6,1,12,22,34,6,6,12,12,22,34,6,,,
fun ,4,1,8,11,19,4,4,8,8,11,19,4,,,
futile ,7,1,12,20,32,7,7,14,12,20,32,7,,,
gallery ,8,1,13,27,40,8,8,16,13,27,40,8,,,
gamblers ,9,1,22,23,45,9,9,18,22,23,45,9,,,
game ,5,1,10,12,22,5,5,10,10,12,22,5,,,
gap ,4,1,8,12,20,4,4,8,8,12,20,4,,,
garbage ,8,1,15,24,39,8,8,16,15,24,39,8,,,
gel ,4,1,6,12,18,4,4,8,6,12,18,4,,,
generation ,11,1,19,25,44,11,11,22,19,25,44,11,,,
give ,5,1,7,18,25,5,5,10,7,18,25,5,,,
gives ,6,1,10,20,30,6,6,12,10,20,30,6,,,
glance ,7,1,14,18,32,7,7,14,14,18,32,7,,,
goes ,5,1,9,12,21,5,5,10,9,12,21,5,,,
going ,6,1,12,17,29,6,6,12,12,17,29,6,,,
goldilocks ,11,1,23,36,59,11,11,22,23,36,59,11,,,
golfers ,8,1,15,23,38,8,8,16,15,23,38,8,,,
gospel ,7,1,15,19,34,7,7,14,15,19,34,7,,,
got ,4,1,7,9,16,4,4,8,7,9,16,4,,,
government ,11,1,22,27,49,11,11,22,22,27,49,11,,,
governments ,12,1,25,29,54,12,12,24,25,29,54,12,,,
granite ,8,1,13,20,33,8,8,16,13,20,33,8,,,
greasy ,7,1,12,21,33,7,7,14,12,21,33,7,,,
great ,6,1,8,16,24,6,6,12,8,16,24,6,,,
grocery ,8,1,15,24,39,8,8,16,15,24,39,8,,,
grow ,5,1,11,14,25,5,5,10,11,14,25,5,,,
growing ,8,1,18,23,41,8,8,16,18,23,41,8,,,
guidelines ,11,1,19,34,53,11,11,22,19,34,53,11,,,
hamburger ,10,1,23,28,51,10,10,20,23,28,51,10,,,
hand ,5,1,10,11,21,5,5,10,10,11,21,5,,,
handicapped ,12,1,27,32,59,12,12,24,27,32,59,12,,,
handle ,7,1,13,17,30,7,7,14,13,17,30,7,,,
handled ,8,1,14,22,36,8,8,16,14,22,36,8,,,
hands ,6,1,13,13,26,6,6,12,13,13,26,6,,,
hate ,5,1,9,8,17,5,5,10,9,8,17,5,,,
having ,7,1,14,21,35,7,7,14,14,21,35,7,,,
healthy ,8,1,18,17,35,8,8,16,18,17,35,8,,,
hear ,5,1,8,11,19,5,5,10,8,11,19,5,,,
heat ,5,1,9,8,17,5,5,10,9,8,17,5,,,
heck ,5,1,12,12,24,5,5,10,12,12,24,5,,,
helps ,6,1,15,13,28,6,6,12,15,13,28,6,,,
here ,5,1,8,10,18,5,5,10,8,10,18,5,,,
heroic ,7,1,15,15,30,7,7,14,15,15,30,7,,,
higher ,7,1,15,17,32,7,7,14,15,17,32,7,,,
highway ,8,1,22,20,42,8,8,16,22,20,42,8,,,
him ,4,1,12,6,18,4,4,8,12,6,18,4,,,
historic ,9,1,21,19,40,9,9,18,21,19,40,9,,,
hold ,5,1,10,13,23,5,5,10,10,13,23,5,,,
hole ,5,1,10,10,20,5,5,10,10,10,20,5,,,
honest ,7,1,16,10,26,7,7,14,16,10,26,7,,,
horn ,5,1,11,9,20,5,5,10,11,9,20,5,,,
hour ,5,1,9,14,23,5,5,10,9,14,23,5,,,
hours ,6,1,12,16,28,6,6,12,12,16,28,6,,,
housekeeper ,12,1,22,33,55,12,12,24,22,33,55,12,,,
how ,4,1,12,6,18,4,4,8,12,6,18,4,,,
ice ,4,1,8,8,16,4,4,8,8,8,16,4,,,
ides ,5,1,8,13,21,5,5,10,8,13,21,5,,,
idiot ,6,1,10,15,25,6,6,12,10,15,25,6,,,
imagination ,12,1,26,27,53,12,12,24,26,27,53,12,,,
increased ,10,1,18,25,43,10,10,20,18,25,43,10,,,
index ,6,1,11,17,28,6,6,12,11,17,28,6,,,
indication ,11,1,23,25,48,11,11,22,23,25,48,11,,,
inefficient ,12,1,27,25,52,12,12,24,27,25,52,12,,,
injustice ,10,1,23,25,48,10,10,20,23,25,48,10,,,
inspiring ,10,1,23,26,49,10,10,20,23,26,49,10,,,
insulation ,11,1,22,27,49,11,11,22,22,27,49,11,,,
insurance ,10,1,20,25,45,10,10,20,20,25,45,10,,,
interactions ,13,1,27,26,53,13,13,26,27,26,53,13,,,
interesting ,12,1,23,26,49,12,12,24,23,26,49,12,,,
interface ,10,1,19,22,41,10,10,20,19,22,41,10,,,
investigate ,12,1,21,31,52,12,12,24,21,31,52,12,,,
irregular ,10,1,13,36,49,10,10,20,13,36,49,10,,,
jammed ,7,1,18,17,35,7,7,14,18,17,35,7,,,
jedi ,5,1,9,15,24,5,5,10,9,15,24,5,,,
jewels ,7,1,17,17,34,7,7,14,17,17,34,7,,,
jobs ,5,1,16,10,26,5,5,10,16,10,26,5,,,
joke ,5,1,10,15,25,5,5,10,10,15,25,5,,,
jones ,6,1,14,12,26,6,6,12,14,12,26,6,,,
judges ,7,1,13,25,38,7,7,14,13,25,38,7,,,
jumped ,7,1,17,22,39,7,7,14,17,22,39,7,,,
justice ,8,1,18,21,39,8,8,16,18,21,39,8,,,
keeps ,6,1,12,16,28,6,6,12,12,16,28,6,,,
kids ,5,1,9,17,26,5,5,10,9,17,26,5,,,
killer ,7,1,11,24,35,7,7,14,11,24,35,7,,,
king ,5,1,10,16,26,5,5,10,10,16,26,5,,,
kissing ,8,1,18,23,41,8,8,16,18,23,41,8,,,
knee ,5,1,8,12,20,5,5,10,8,12,20,5,,,
knees ,6,1,11,14,25,6,6,12,11,14,25,6,,,
knocking ,9,1,21,27,48,9,9,18,21,27,48,9,,,
labour ,7,1,14,21,35,7,7,14,14,21,35,7,,,
lagoon ,7,1,13,18,31,7,7,14,13,18,31,7,,,
lamb ,5,1,15,10,25,5,5,10,15,10,25,5,,,
land ,5,1,8,14,22,5,5,10,8,14,22,5,,,
laser ,6,1,9,16,25,6,6,12,9,16,25,6,,,
last ,5,1,9,11,20,5,5,10,9,11,20,5,,,
later ,6,1,8,15,23,6,6,12,8,15,23,6,,,
laugh ,6,1,11,20,31,6,6,12,11,20,31,6,,,
laundry ,8,1,13,28,41,8,8,16,13,28,41,8,,,
lavatory ,9,1,14,29,43,9,9,18,14,29,43,9,,,
leap ,5,1,9,13,22,5,5,10,9,13,22,5,,,
learning ,9,1,16,24,40,9,9,18,16,24,40,9,,,
leather ,8,1,13,18,31,8,8,16,13,18,31,8,,,
leaving ,8,1,13,26,39,8,8,16,13,26,39,8,,,
left ,5,1,9,11,20,5,5,10,9,11,20,5,,,
lender ,7,1,10,19,29,7,7,14,10,19,29,7,,,
lens ,5,1,10,10,20,5,5,10,10,10,20,5,,,
lesson ,7,1,15,14,29,7,7,14,15,14,29,7,,,
letters ,8,1,13,17,30,8,8,16,13,17,30,8,,,
liar ,5,1,7,15,22,5,5,10,7,15,22,5,,,
limit ,6,1,14,13,27,6,6,12,14,13,27,6,,,
limited ,8,1,16,20,36,8,8,16,16,20,36,8,,,
line ,5,1,9,11,20,5,5,10,9,11,20,5,,,
living ,7,1,13,24,37,7,7,14,13,24,37,7,,,
location ,9,1,19,19,38,9,9,18,19,19,38,9,,,
long ,5,1,10,13,23,5,5,10,10,13,23,5,,,
longer ,7,1,12,19,31,7,7,14,12,19,31,7,,,
looses ,7,1,14,15,29,7,7,14,14,15,29,7,,,
losers ,7,1,13,17,30,7,7,14,13,17,30,7,,,
lost ,5,1,10,10,20,5,5,10,10,10,20,5,,,
lottery ,8,1,14,19,33,8,8,16,14,19,33,8,,,
loudly ,7,1,12,26,38,7,7,14,12,26,38,7,,,
lovely ,7,1,12,24,36,7,7,14,12,24,36,7,,,
low ,4,1,10,9,19,4,4,8,10,9,19,4,,,
luckily ,8,1,17,30,47,8,8,16,17,30,47,8,,,
lunch ,6,1,15,15,30,6,6,12,15,15,30,6,,,
lydia ,6,1,10,20,30,6,6,12,10,20,30,6,,,
machine ,8,1,21,14,35,8,8,16,21,14,35,8,,,
machinery ,10,1,25,22,47,10,10,20,25,22,47,10,,,
mail ,5,1,11,12,23,5,5,10,11,12,23,5,,,
majesty ,8,1,20,18,38,8,8,16,20,18,38,8,,,
makeup ,7,1,15,22,37,7,7,14,15,22,37,7,,,
march ,6,1,16,12,28,6,6,12,16,12,28,6,,,
mary ,5,1,11,13,24,5,5,10,11,13,24,5,,,
mask ,5,1,12,13,25,5,5,10,12,13,25,5,,,
maternity ,10,1,21,21,42,10,10,20,21,21,42,10,,,
maximum ,8,1,23,21,44,8,8,16,23,21,44,8,,,
medieval ,9,1,15,28,43,9,9,18,15,28,43,9,,,
men ,4,1,10,5,15,4,4,8,10,5,15,4,,,
merger ,7,1,12,19,31,7,7,14,12,19,31,7,,,
met ,4,1,9,5,14,4,4,8,9,5,14,4,,,
meter ,6,1,11,11,22,6,6,12,11,11,22,6,,,
mice ,5,1,13,9,22,5,5,10,13,9,22,5,,,
microscopes ,12,1,32,26,58,12,12,24,32,26,58,12,,,
might ,6,1,16,12,28,6,6,12,16,12,28,6,,,
mightier ,9,1,20,21,41,9,9,18,20,21,41,9,,,
mine ,5,1,12,8,20,5,5,10,12,8,20,5,,,
minimum ,8,1,24,17,41,8,8,16,24,17,41,8,,,
minute ,7,1,15,15,30,7,7,14,15,15,30,7,,,
missed ,7,1,16,16,32,7,7,14,16,16,32,7,,,
mission ,8,1,21,15,36,8,8,16,21,15,36,8,,,
mix ,4,1,11,10,21,4,4,8,11,10,21,4,,,
moderation ,11,1,21,25,46,11,11,22,21,25,46,11,,,
mom ,4,1,13,5,18,4,4,8,13,5,18,4,,,
monitored ,10,1,20,22,42,10,10,20,20,22,42,10,,,
months ,7,1,20,9,29,7,7,14,20,9,29,7,,,
mortgage ,9,1,17,24,41,9,9,18,17,24,41,9,,,
mother ,7,1,16,12,28,7,7,14,16,12,28,7,,,
motivational ,13,1,26,32,58,13,13,26,26,32,58,13,,,
murder ,7,1,11,23,34,7,7,14,11,23,34,7,,,
mystery ,8,1,19,19,38,8,8,16,19,19,38,8,,,
nasty ,6,1,13,12,25,6,6,12,13,12,25,6,,,
nations ,8,1,17,14,31,8,8,16,17,14,31,8,,,
near ,5,1,7,11,18,5,5,10,7,11,18,5,,,
nearby ,7,1,16,16,32,7,7,14,16,16,32,7,,,
needed ,7,1,9,18,27,7,7,14,9,18,27,7,,,
neither ,8,1,15,15,30,8,8,16,15,15,30,8,,,
nervous ,8,1,13,25,38,8,8,16,13,25,38,8,,,
nice ,5,1,11,9,20,5,5,10,11,9,20,5,,,
night ,6,1,14,12,26,6,6,12,14,12,26,6,,,
nobody ,7,1,18,16,34,7,7,14,18,16,34,7,,,
non ,4,1,9,5,14,4,4,8,9,5,14,4,,,
noon ,5,1,11,7,18,5,5,10,11,7,18,5,,,
nor ,4,1,7,8,15,4,4,8,7,8,15,4,,,
note ,5,1,9,7,16,5,5,10,9,7,16,5,,,
now ,4,1,11,6,17,4,4,8,11,6,17,4,,,
number ,7,1,18,16,34,7,7,14,18,16,34,7,,,
nutty ,6,1,12,14,26,6,6,12,12,14,26,6,,,
obey ,5,1,13,10,23,5,5,10,13,10,23,5,,,
objective ,10,1,24,25,49,10,10,20,24,25,49,10,,,
obligations ,12,1,28,28,56,12,12,24,28,28,56,12,,,
observation ,12,1,25,29,54,12,12,24,25,29,54,12,,,
occasional ,11,1,25,25,50,11,11,22,25,25,50,11,,,
occur ,6,1,13,17,30,6,6,12,13,17,30,6,,,
oceans ,7,1,15,13,28,7,7,14,15,13,28,7,,,
odd ,4,1,5,13,18,4,4,8,5,13,18,4,,,
offenders ,10,1,19,25,44,10,10,20,19,25,44,10,,,
offends ,8,1,17,19,36,8,8,16,17,19,36,8,,,
offensive ,10,1,20,26,46,10,10,20,20,26,46,10,,,
offer ,6,1,11,15,26,6,6,12,11,15,26,6,,,
oil ,4,1,7,10,17,4,4,8,7,10,17,4,,,
ok ,3,1,5,9,14,3,3,6,5,9,14,3,,,
old ,4,1,6,12,18,4,4,8,6,12,18,4,,,
olympic ,8,1,23,20,43,8,8,16,23,20,43,8,,,
opera ,6,1,10,15,25,6,6,12,10,15,25,6,,,
opposing ,9,1,23,22,45,9,9,18,23,22,45,9,,,
order ,6,1,7,18,25,6,6,12,7,18,25,6,,,
ordered ,8,1,9,25,34,8,8,16,9,25,34,8,,,
organize ,9,1,19,23,42,9,9,18,19,23,42,9,,,
overdrawn ,10,1,17,31,48,10,10,20,17,31,48,10,,,
owned ,6,1,13,13,26,6,6,12,13,13,26,6,,,
paid ,5,1,9,15,24,5,5,10,9,15,24,5,,,
paintings ,10,1,23,23,46,10,10,20,23,23,46,10,,,
panel ,6,1,12,14,26,6,6,12,12,14,26,6,,,
park ,5,1,9,17,26,5,5,10,9,17,26,5,,,
parkways ,9,1,21,28,49,9,9,18,21,28,49,9,,,
parties ,8,1,15,19,34,8,8,16,15,19,34,8,,,
parts ,6,1,12,14,26,6,6,12,12,14,26,6,,,
party ,6,1,12,16,28,6,6,12,12,16,28,6,,,
patio ,6,1,12,13,25,6,6,12,12,13,25,6,,,
pay ,4,1,9,11,20,4,4,8,9,11,20,4,,,
peanuts ,8,1,16,19,35,8,8,16,16,19,35,8,,,
peek ,5,1,9,14,23,5,5,10,9,14,23,5,,,
peering ,8,1,15,21,36,8,8,16,15,21,36,8,,,
pen ,4,1,9,7,16,4,4,8,9,7,16,4,,,
penalty ,8,1,17,19,36,8,8,16,17,19,36,8,,,
period ,7,1,12,20,32,7,7,14,12,20,32,7,,,
persistent ,11,1,23,22,45,11,11,22,23,22,45,11,,,
person ,7,1,15,15,30,7,7,14,15,15,30,7,,,
personal ,9,1,18,22,40,9,9,18,18,22,40,9,,,
persons ,8,1,18,17,35,8,8,16,18,17,35,8,,,
phenomenon ,11,1,29,17,46,11,11,22,29,17,46,11,,,
photographs ,12,1,30,28,58,12,12,24,30,28,58,12,,,
phrases ,8,1,18,18,36,8,8,16,18,18,36,8,,,
physics ,8,1,24,18,42,8,8,16,24,18,42,8,,,
picket ,7,1,16,18,34,7,7,14,16,18,34,7,,,
picture ,8,1,16,22,38,8,8,16,16,22,38,8,,,
pies ,5,1,11,11,22,5,5,10,11,11,22,5,,,
pig ,4,1,9,12,21,4,4,8,9,12,21,4,,,
pile ,5,1,10,13,23,5,5,10,10,13,23,5,,,
pimp ,5,1,16,11,27,5,5,10,16,11,27,5,,,
pizza ,6,1,20,14,34,6,6,12,20,14,34,6,,,
played ,7,1,13,22,35,7,7,14,13,22,35,7,,,
players ,8,1,16,23,39,8,8,16,16,23,39,8,,,
playing ,8,1,18,24,42,8,8,16,18,24,42,8,,,
pleasant ,9,1,18,20,38,9,9,18,18,20,38,9,,,
plug ,5,1,10,19,29,5,5,10,10,19,29,5,,,
poisonous ,10,1,23,24,47,10,10,20,23,24,47,10,,,
political ,10,1,22,26,48,10,10,20,22,26,48,10,,,
politics ,9,1,22,21,43,9,9,18,22,21,43,9,,,
poorest ,8,1,16,17,33,8,8,16,16,17,33,8,,,
popularity ,11,1,23,34,57,11,11,22,23,34,57,11,,,
population ,11,1,24,29,53,11,11,22,24,29,53,11,,,
postal ,7,1,15,16,31,7,7,14,15,16,31,7,,,
powder ,7,1,15,19,34,7,7,14,15,19,34,7,,,
power ,6,1,14,14,28,6,6,12,14,14,28,6,,,
prayer ,7,1,12,21,33,7,7,14,12,21,33,7,,,
precautions ,12,1,25,30,55,12,12,24,25,30,55,12,,,
predictable ,12,1,26,31,57,12,12,24,26,31,57,12,,,
prefer ,7,1,12,19,31,7,7,14,12,19,31,7,,,
preferred ,10,1,15,30,45,10,10,20,15,30,45,10,,,
prepare ,8,1,14,22,36,8,8,16,14,22,36,8,,,
prescription ,13,1,30,31,61,13,13,26,30,31,61,13,,,
presence ,9,1,19,19,38,9,9,18,19,19,38,9,,,
presentation ,13,1,26,26,52,13,13,26,26,26,52,13,,,
presidential ,13,1,24,34,58,13,13,26,24,34,58,13,,,
presidents ,11,1,22,26,48,11,11,22,22,26,48,11,,,
prevailing ,11,1,20,36,56,11,11,22,20,36,56,11,,,
price ,6,1,13,15,28,6,6,12,13,15,28,6,,,
printer ,8,1,15,19,34,8,8,16,15,19,34,8,,,
priorities ,11,1,21,28,49,11,11,22,21,28,49,11,,,
priority ,9,1,18,25,43,9,9,18,18,25,43,9,,,
prison ,7,1,16,16,32,7,7,14,16,16,32,7,,,
prize ,6,1,15,15,30,6,6,12,15,15,30,6,,,
problem ,8,1,22,18,40,8,8,16,22,18,40,8,,,
problems ,9,1,25,20,45,9,9,18,25,20,45,9,,,
professor ,10,1,21,25,46,10,10,20,21,25,46,10,,,
profit ,7,1,15,17,32,7,7,14,15,17,32,7,,,
proposal ,9,1,20,24,44,9,9,18,20,24,44,9,,,
proprietor ,11,1,21,29,50,11,11,22,21,29,50,11,,,
protect ,8,1,17,16,33,8,8,16,17,16,33,8,,,
protesters ,11,1,21,24,45,11,11,22,21,24,45,11,,,
provide ,8,1,13,27,40,8,8,16,13,27,40,8,,,
provided ,9,1,14,32,46,9,9,18,14,32,46,9,,,
provinces ,10,1,22,27,49,10,10,20,22,27,49,10,,,
psychiatrist ,13,1,32,30,62,13,13,26,32,30,62,13,,,
psychology ,11,1,30,30,60,11,11,22,30,30,60,11,,,
public ,7,1,20,20,40,7,7,14,20,20,40,7,,,
published ,10,1,25,28,53,10,10,20,25,28,53,10,,,
pumping ,8,1,22,23,45,8,8,16,22,23,45,8,,,
punishment ,11,1,29,22,51,11,11,22,29,22,51,11,,,
quacks ,7,1,17,23,40,7,7,14,17,23,40,7,,,
quakes ,7,1,14,23,37,7,7,14,14,23,37,7,,,
quarter ,8,1,13,24,37,8,8,16,13,24,37,8,,,
questioning ,12,1,27,30,57,12,12,24,27,30,57,12,,,
quickly ,8,1,20,29,49,8,8,16,20,29,49,8,,,
quit ,5,1,11,14,25,5,5,10,11,14,25,5,,,
quite ,6,1,12,16,28,6,6,12,12,16,28,6,,,
quota ,6,1,12,16,28,6,6,12,12,16,28,6,,,
race ,5,1,8,12,20,5,5,10,8,12,20,5,,,
racketball ,11,1,23,31,54,11,11,22,23,31,54,11,,,
raged ,6,1,7,20,27,6,6,12,7,20,27,6,,,
raindrops ,10,1,19,28,47,10,10,20,19,28,47,10,,,
raise ,6,1,9,15,24,6,6,12,9,15,24,6,,,
rapidly ,8,1,15,27,42,8,8,16,15,27,42,8,,,
rationale ,10,1,16,24,40,10,10,20,16,24,40,10,,,
rattle ,7,1,10,16,26,7,7,14,10,16,26,7,,,
reach ,6,1,12,13,25,6,6,12,12,13,25,6,,,
really ,7,1,11,22,33,7,7,14,11,22,33,7,,,
receipts ,9,1,19,20,39,9,9,18,19,20,39,9,,,
recruitment ,12,1,24,28,52,12,12,24,24,28,52,12,,,
rectangular ,12,1,20,36,56,12,12,24,20,36,56,12,,,
recycling ,10,1,23,28,51,10,10,20,23,28,51,10,,,
redouble ,9,1,16,27,43,9,9,18,16,27,43,9,,,
redress ,8,1,12,22,34,8,8,16,12,22,34,8,,,
referendum ,11,1,19,31,50,11,11,22,19,31,50,11,,,
refuse ,7,1,11,20,31,7,7,14,11,20,31,7,,,
registration ,13,1,23,32,55,13,13,26,23,32,55,13,,,
rejection ,10,1,21,22,43,10,10,20,21,22,43,10,,,
relations ,10,1,18,23,41,10,10,20,18,23,41,10,,,
religion ,9,1,16,25,41,9,9,18,16,25,41,9,,,
reluctant ,10,1,18,25,43,10,10,20,18,25,43,10,,,
rent ,5,1,8,9,17,5,5,10,8,9,17,5,,,
require ,8,1,13,25,38,8,8,16,13,25,38,8,,,
requires ,9,1,16,27,43,9,9,18,16,27,43,9,,,
restaurant ,11,1,17,28,45,11,11,22,17,28,45,11,,,
result ,7,1,11,20,31,7,7,14,11,20,31,7,,,
results ,8,1,14,22,36,8,8,16,14,22,36,8,,,
return ,7,1,10,19,29,7,7,14,10,19,29,7,,,
rich ,5,1,12,11,23,5,5,10,12,11,23,5,,,
rid ,4,1,5,13,18,4,4,8,5,13,18,4,,,
ridiculous ,11,1,20,38,58,11,11,22,20,38,58,11,,,
riding ,7,1,12,22,34,7,7,14,12,22,34,7,,,
rife ,5,1,8,13,21,5,5,10,8,13,21,5,,,
rings ,6,1,12,16,28,6,6,12,12,16,28,6,,,
risen ,6,1,11,13,24,6,6,12,11,13,24,6,,,
roads ,6,1,9,17,26,6,6,12,9,17,26,6,,,
robin ,6,1,15,12,27,6,6,12,15,12,27,6,,,
rocks ,6,1,13,17,30,6,6,12,13,17,30,6,,,
roman ,6,1,13,12,25,6,6,12,13,12,25,6,,,
ropes ,6,1,12,14,26,6,6,12,12,14,26,6,,,
rover ,6,1,7,20,27,6,6,12,7,20,27,6,,,
rules ,6,1,9,19,28,6,6,12,9,19,28,6,,,
running ,8,1,16,22,38,8,8,16,16,22,38,8,,,
runs ,5,1,9,14,23,5,5,10,9,14,23,5,,,
sad ,4,1,6,11,17,4,4,8,6,11,17,4,,,
saddles ,8,1,13,24,37,8,8,16,13,24,37,8,,,
safe ,5,1,9,11,20,5,5,10,9,11,20,5,,,
safety ,7,1,14,16,30,7,7,14,14,16,30,7,,,
salesmen ,9,1,20,18,38,9,9,18,20,18,38,9,,,
sam ,4,1,10,7,17,4,4,8,10,7,17,4,,,
sample ,7,1,17,16,33,7,7,14,17,16,33,7,,,
santa ,6,1,11,11,22,6,6,12,11,11,22,6,,,
saturday ,9,1,14,29,43,9,9,18,14,29,43,9,,,
saturn ,7,1,12,18,30,7,7,14,12,18,30,7,,,
saving ,7,1,13,22,35,7,7,14,13,22,35,7,,,
says ,5,1,11,12,23,5,5,10,11,12,23,5,,,
scene ,6,1,13,10,23,6,6,12,13,10,23,6,,,
scheduling ,11,1,24,32,56,11,11,22,24,32,56,11,,,
schools ,8,1,21,16,37,8,8,16,21,16,37,8,,,
scratch ,8,1,20,16,36,8,8,16,20,16,36,8,,,
season ,7,1,14,13,27,7,7,14,14,13,27,7,,,
seasoned ,9,1,16,20,36,9,9,18,16,20,36,9,,,
seasons ,8,1,17,15,32,8,8,16,17,15,32,8,,,
seat ,5,1,8,9,17,5,5,10,8,9,17,5,,,
second ,7,1,15,15,30,7,7,14,15,15,30,7,,,
security ,9,1,18,25,43,9,9,18,18,25,43,9,,,
seems ,6,1,14,10,24,6,6,12,14,10,24,6,,,
seen ,5,1,9,8,17,5,5,10,9,8,17,5,,,
sees ,5,1,9,9,18,5,5,10,9,9,18,5,,,
seminars ,9,1,20,19,39,9,9,18,20,19,39,9,,,
sends ,6,1,12,13,25,6,6,12,12,13,25,6,,,
sentence ,9,1,19,14,33,9,9,18,19,14,33,9,,,
service ,8,1,14,23,37,8,8,16,14,23,37,8,,,
services ,9,1,17,25,42,9,9,18,17,25,42,9,,,
shack ,6,1,15,15,30,6,6,12,15,15,30,6,,,
shall ,6,1,13,15,28,6,6,12,13,15,28,6,,,
sheds ,6,1,13,13,26,6,6,12,13,13,26,6,,,
ship ,5,1,14,10,24,5,5,10,14,10,24,5,,,
shirts ,7,1,16,14,30,7,7,14,16,14,30,7,,,
shivering ,10,1,20,29,49,10,10,20,20,29,49,10,,,
short ,6,1,13,11,24,6,6,12,13,11,24,6,,,
shoulders ,10,1,19,29,48,10,10,20,19,29,48,10,,,
shouting ,9,1,20,22,42,9,9,18,20,22,42,9,,,
shrine ,7,1,15,14,29,7,7,14,15,14,29,7,,,
sick ,5,1,12,14,26,5,5,10,12,14,26,5,,,
sides ,6,1,11,15,26,6,6,12,11,15,26,6,,,
sign ,5,1,11,12,23,5,5,10,11,12,23,5,,,
silver ,7,1,11,23,34,7,7,14,11,23,34,7,,,
sing ,5,1,11,12,23,5,5,10,11,12,23,5,,,
sister ,7,1,13,15,28,7,7,14,13,15,28,7,,,
sit ,4,1,8,7,15,4,4,8,8,7,15,4,,,
size ,5,1,13,10,23,5,5,10,13,10,23,5,,,
skate ,6,1,10,15,25,6,6,12,10,15,25,6,,,
skimmed ,8,1,20,21,41,8,8,16,20,21,41,8,,,
slip ,5,1,12,13,25,5,5,10,12,13,25,5,,,
slippery ,9,1,21,26,47,9,9,18,21,26,47,9,,,
slow ,5,1,13,11,24,5,5,10,13,11,24,5,,,
snake ,6,1,11,15,26,6,6,12,11,15,26,6,,,
snow ,5,1,14,8,22,5,5,10,14,8,22,5,,,
socket ,7,1,15,16,31,7,7,14,15,16,31,7,,,
sold ,5,1,9,14,23,5,5,10,9,14,23,5,,,
sons ,5,1,12,8,20,5,5,10,12,8,20,5,,,
soon ,5,1,11,8,19,5,5,10,11,8,19,5,,,
sound ,6,1,11,17,28,6,6,12,11,17,28,6,,,
sounds ,7,1,14,19,33,7,7,14,14,19,33,7,,,
space ,6,1,14,13,27,6,6,12,14,13,27,6,,,
spaghetti ,10,1,22,22,44,10,10,20,22,22,44,10,,,
speak ,6,1,12,17,29,6,6,12,12,17,29,6,,,
spectacular ,12,1,25,33,58,12,12,24,25,33,58,12,,,
speech ,7,1,18,13,31,7,7,14,18,13,31,7,,,
speeding ,9,1,18,24,42,9,9,18,18,24,42,9,,,
spilled ,8,1,16,24,40,8,8,16,16,24,40,8,,,
spoonful ,9,1,21,24,45,9,9,18,21,24,45,9,,,
sport ,6,1,13,13,26,6,6,12,13,13,26,6,,,
spot ,5,1,12,9,21,5,5,10,12,9,21,5,,,
squander ,9,1,17,27,44,9,9,18,17,27,44,9,,,
stability ,10,1,24,23,47,10,10,20,24,23,47,10,,,
stage ,6,1,10,14,24,6,6,12,10,14,24,6,,,
starlight ,10,1,20,25,45,10,10,20,20,25,45,10,,,
statement ,10,1,21,15,36,10,10,20,21,15,36,10,,,
stay ,5,1,10,11,21,5,5,10,10,11,21,5,,,
steep ,6,1,12,11,23,6,6,12,12,11,23,6,,,
step ,5,1,11,9,20,5,5,10,11,9,20,5,,,
sticker ,8,1,16,21,37,8,8,16,16,21,37,8,,,
stiff ,6,1,14,13,27,6,6,12,14,13,27,6,,,
stimulus ,9,1,20,26,46,9,9,18,20,26,46,9,,,
stock ,6,1,14,14,28,6,6,12,14,14,28,6,,,
stop ,5,1,12,9,21,5,5,10,12,9,21,5,,,
store ,6,1,10,12,22,6,6,12,10,12,22,6,,,
strained ,9,1,15,22,37,9,9,18,15,22,37,9,,,
strangers ,10,1,18,25,43,10,10,20,18,25,43,10,,,
streets ,8,1,14,15,29,8,8,16,14,15,29,8,,,
stupid ,7,1,14,21,35,7,7,14,14,21,35,7,,,
style ,6,1,12,14,26,6,6,12,12,14,26,6,,,
subdivisions ,13,1,30,38,68,13,13,26,30,38,68,13,,,
subjects ,9,1,25,21,46,9,9,18,25,21,46,9,,,
subtraction ,12,1,28,27,55,12,12,24,28,27,55,12,,,
suburbs ,8,1,22,23,45,8,8,16,22,23,45,8,,,
succeed ,8,1,16,22,38,8,8,16,16,22,38,8,,,
such ,5,1,13,12,25,5,5,10,13,12,25,5,,,
sucker ,7,1,13,23,36,7,7,14,13,23,36,7,,,
suggests ,9,1,18,26,44,9,9,18,18,26,44,9,,,
suite ,6,1,10,15,25,6,6,12,10,15,25,6,,,
sum ,4,1,10,10,20,4,4,8,10,10,20,4,,,
summit ,7,1,19,15,34,7,7,14,19,15,34,7,,,
sun ,4,1,8,10,18,4,4,8,8,10,18,4,,,
sunday ,7,1,13,22,35,7,7,14,13,22,35,7,,,
sunny ,6,1,14,15,29,6,6,12,14,15,29,6,,,
sunset ,7,1,14,15,29,7,7,14,14,15,29,7,,,
super ,6,1,11,18,29,6,6,12,11,18,29,6,,,
superman ,9,1,20,23,43,9,9,18,20,23,43,9,,,
sure ,5,1,7,15,22,5,5,10,7,15,22,5,,,
surgery ,8,1,13,28,41,8,8,16,13,28,41,8,,,
swamp ,6,1,19,12,31,6,6,12,19,12,31,6,,,
sweatshirt ,11,1,25,22,47,11,11,22,25,22,47,11,,,
swim ,5,1,16,9,25,5,5,10,16,9,25,5,,,
sword ,6,1,13,16,29,6,6,12,13,16,29,6,,,
syllabus ,9,1,22,27,49,9,9,18,22,27,49,9,,,
sympathy ,9,1,26,20,46,9,9,18,26,20,46,9,,,
tabletop ,9,1,21,18,39,9,9,18,21,18,39,9,,,
taking ,7,1,13,20,33,7,7,14,13,20,33,7,,,
talking ,8,1,15,24,39,8,8,16,15,24,39,8,,,
tape ,5,1,9,10,19,5,5,10,9,10,19,5,,,
taste ,6,1,10,10,20,6,6,12,10,10,20,6,,,
taxation ,9,1,17,20,37,9,9,18,17,20,37,9,,,
teaching ,9,1,20,19,39,9,9,18,20,19,39,9,,,
tell ,5,1,8,12,20,5,5,10,8,12,20,5,,,
temperament ,12,1,27,22,49,12,12,24,27,22,49,12,,,
tennis ,7,1,15,11,26,7,7,14,15,11,26,7,,,
tests ,6,1,12,9,21,6,6,12,12,9,21,6,,,
thank ,6,1,13,13,26,6,6,12,13,13,26,6,,,
thigh ,6,1,15,12,27,6,6,12,15,12,27,6,,,
thin ,5,1,12,7,19,5,5,10,12,7,19,5,,,
thinking ,9,1,21,22,43,9,9,18,21,22,43,9,,,
thorough ,9,1,19,23,42,9,9,18,19,23,42,9,,,
thoroughly ,11,1,24,31,55,11,11,22,24,31,55,11,,,
those ,6,1,13,9,22,6,6,12,13,9,22,6,,,
thousand ,9,1,18,22,40,9,9,18,18,22,40,9,,,
tire ,5,1,7,11,18,5,5,10,7,11,18,5,,,
toes ,5,1,9,8,17,5,5,10,9,8,17,5,,,
together ,9,1,16,19,35,9,9,18,16,19,35,9,,,
toil ,5,1,9,11,20,5,5,10,9,11,20,5,,,
top ,4,1,9,7,16,4,4,8,9,7,16,4,,,
toss ,5,1,11,8,19,5,5,10,11,8,19,5,,,
touchdown ,10,1,25,23,48,10,10,20,25,23,48,10,,,
tower ,6,1,12,12,24,6,6,12,12,12,24,6,,,
traditional ,12,1,20,31,51,12,12,24,20,31,51,12,,,
traffic ,8,1,17,20,37,8,8,16,17,20,37,8,,,
train ,6,1,10,13,23,6,6,12,10,13,23,6,,,
trains ,7,1,13,15,28,7,7,14,13,15,28,7,,,
transaction ,12,1,25,24,49,12,12,24,25,24,49,12,,,
transit ,8,1,15,16,31,8,8,16,15,16,31,8,,,
travel ,7,1,9,22,31,7,7,14,9,22,31,7,,,
treasure ,9,1,12,25,37,9,9,18,12,25,37,9,,,
treasurer ,10,1,13,29,42,10,10,20,13,29,42,10,,,
treasury ,9,1,14,27,41,9,9,18,14,27,41,9,,,
treat ,6,1,8,12,20,6,6,12,8,12,20,6,,,
tree ,5,1,6,10,16,5,5,10,6,10,16,5,,,
tried ,6,1,8,16,24,6,6,12,8,16,24,6,,,
triple ,7,1,13,18,31,7,7,14,13,18,31,7,,,
trouble ,8,1,16,21,37,8,8,16,16,21,37,8,,,
trucks ,7,1,14,22,36,7,7,14,14,22,36,7,,,
tumor ,6,1,12,15,27,6,6,12,12,15,27,6,,,
turfed ,7,1,10,22,32,7,7,14,10,22,32,7,,,
turn ,5,1,8,13,21,5,5,10,8,13,21,5,,,
turtleneck ,11,1,20,30,50,11,11,22,20,30,50,11,,,
unacceptable ,13,1,31,31,62,13,13,26,31,31,62,13,,,
unavailable ,12,1,22,38,60,12,12,24,22,38,60,12,,,
understood ,11,1,18,31,49,11,11,22,18,31,49,11,,,
underwent ,10,1,19,25,44,10,10,20,19,25,44,10,,,
unfortunate ,12,1,21,31,52,12,12,24,21,31,52,12,,,
unicycle ,9,1,21,25,46,9,9,18,21,25,46,9,,,
union ,6,1,12,14,26,6,6,12,12,14,26,6,,,
unions ,7,1,15,16,31,7,7,14,15,16,31,7,,,
universally ,12,1,21,41,62,12,12,24,21,41,62,12,,,
universities ,13,1,23,37,60,13,13,26,23,37,60,13,,,
until ,6,1,11,16,27,6,6,12,11,16,27,6,,,
use ,4,1,6,11,17,4,4,8,6,11,17,4,,,
user ,5,1,7,15,22,5,5,10,7,15,22,5,,,
usually ,8,1,14,30,44,8,8,16,14,30,44,8,,,
valid ,6,1,8,23,31,6,6,12,8,23,31,6,,,
validated ,10,1,13,34,47,10,10,20,13,34,47,10,,,
valium ,7,1,13,25,38,7,7,14,13,25,38,7,,,
vanilla ,8,1,13,26,39,8,8,16,13,26,39,8,,,
ventilation ,12,1,22,29,51,12,12,24,22,29,51,12,,,
verbs ,6,1,13,17,30,6,6,12,13,17,30,6,,,
victims ,8,1,20,20,40,8,8,16,20,20,40,8,,,
video ,6,1,8,20,28,6,6,12,8,20,28,6,,,
visited ,8,1,13,24,37,8,8,16,13,24,37,8,,,
voice ,6,1,11,17,28,6,6,12,11,17,28,6,,,
vote ,5,1,7,13,20,5,5,10,7,13,20,5,,,
voters ,7,1,11,19,30,7,7,14,11,19,30,7,,,
wallet ,7,1,14,17,31,7,7,14,14,17,31,7,,,
war ,4,1,8,10,18,4,4,8,8,10,18,4,,,
warranty ,9,1,18,23,41,9,9,18,18,23,41,9,,,
waves ,6,1,12,17,29,6,6,12,12,17,29,6,,,
wear ,5,1,9,12,21,5,5,10,9,12,21,5,,,
web ,4,1,13,6,19,4,4,8,13,6,19,4,,,
week ,5,1,10,13,23,5,5,10,10,13,23,5,,,
weekends ,9,1,18,23,41,9,9,18,18,23,41,9,,,
weeping ,8,1,19,19,38,8,8,16,19,19,38,8,,,
well ,5,1,11,13,24,5,5,10,11,13,24,5,,,
went ,5,1,12,7,19,5,5,10,12,7,19,5,,,
while ,6,1,15,13,28,6,6,12,15,13,28,6,,,
whole ,6,1,15,12,27,6,6,12,15,12,27,6,,,
why ,4,1,13,8,21,4,4,8,13,8,21,4,,,
wider ,6,1,11,17,28,6,6,12,11,17,28,6,,,
willows ,8,1,22,20,42,8,8,16,22,20,42,8,,,
windy ,6,1,15,16,31,6,6,12,15,16,31,6,,,
winner ,7,1,16,14,30,7,7,14,16,14,30,7,,,
winners ,8,1,19,16,35,8,8,16,19,16,35,8,,,
winter ,7,1,15,14,29,7,7,14,15,14,29,7,,,
wisdom ,7,1,19,16,35,7,7,14,19,16,35,7,,,
wishful ,8,1,21,22,43,8,8,16,21,22,43,8,,,
withdrawal ,11,1,25,29,54,11,11,22,25,29,54,11,,,
witnesses ,10,1,24,18,42,10,10,20,24,18,42,10,,,
women ,6,1,17,9,26,6,6,12,17,9,26,6,,,
wonderful ,10,1,20,30,50,10,10,20,20,30,50,10,,,
wore ,5,1,10,11,21,5,5,10,10,11,21,5,,,
working ,8,1,18,24,42,8,8,16,18,24,42,8,,,
worm ,5,1,14,10,24,5,5,10,14,10,24,5,,,
worry ,6,1,13,17,30,6,6,12,13,17,30,6,,,
worth ,6,1,15,11,26,6,6,12,15,11,26,6,,,
writing ,8,1,18,20,38,8,8,16,18,20,38,8,,,
wrote ,6,1,12,12,24,6,6,12,12,12,24,6,,,
yap ,4,1,9,11,20,4,4,8,9,11,20,4,,,
year ,5,1,7,14,21,5,5,10,7,14,21,5,,,
years ,6,1,10,16,26,6,6,12,10,16,26,6,,,
yes ,4,1,8,9,17,4,4,8,8,9,17,4,,,
yet ,4,1,7,8,15,4,4,8,7,8,15,4,,,
young ,6,1,12,19,31,6,6,12,12,19,31,6,,,
zoom ,5,1,16,8,24,5,5,10,16,8,24,5,,,
