word;Nb_char (C_w);Freq (F_w);Nb_scan_block (S_w_b);Nb_scan_key (S_w_k);Nb_scan (S_w);Nb_act_block;Nb_act_key;Nb_act;S_w_b x F_w;S_w_k x F_w;S_w x F_w;C_w x F_w
de ;3;369294;3;12;15;3;3;6;1107882;4431528;5539410;1107882
la ;3;231160;4;7;11;3;3;6;924640;1618120;2542760;693480
le ;3;201192;4;11;15;3;3;6;804768;2213112;3017880;603576
les ;4;172027;7;13;20;4;4;8;1204189;2236351;3440540;688108
et ;3;162818;5;10;15;3;3;6;814090;1628180;2442270;488454
a ;2;142169;2;3;5;2;2;4;284338;426507;710845;284338
est ;4;139273;8;12;20;4;4;8;1114184;1671276;2785460;557092
en ;3;131424;4;13;17;3;3;6;525696;1708512;2234208;394272
des ;4;128016;6;14;20;4;4;8;768096;1792224;2560320;512064
d ;2;106690;2;6;8;2;2;4;213380;640140;853520;213380
un ;3;98321;6;11;17;3;3;6;589926;1081531;1671457;294963
il ;3;86530;5;6;11;3;3;6;432650;519180;951830;259590
du ;3;81566;5;10;15;3;3;6;407830;815660;1223490;244698
une ;4;77779;7;17;24;4;4;8;544453;1322243;1866696;311116
qui ;4;63007;8;15;23;4;4;8;504056;945105;1449161;252028
dans ;5;62106;8;16;24;5;5;10;496848;993696;1490544;310530
pour ;5;59206;11;21;32;5;5;10;651266;1243326;1894592;296030
par ;4;55637;7;12;19;4;4;8;389459;667644;1057103;222548
au ;3;46340;5;7;12;3;3;6;231700;324380;556080;139020
que ;4;45724;7;20;27;4;4;8;320068;914480;1234548;182896
plus ;5;41215;11;19;30;5;5;10;453365;783085;1236450;206075
sont ;5;40154;11;19;30;5;5;10;441694;762926;1204620;200770
se ;3;35559;5;9;14;3;3;6;177795;320031;497826;106677
c ;2;34853;2;5;7;2;2;4;69706;174265;243971;69706
sur ;4;34442;10;8;18;4;4;8;344420;275536;619956;137768
ou ;3;31878;6;12;18;3;3;6;191268;382536;573804;95634
on ;3;30509;5;14;19;3;3;6;152545;427126;579671;91527
son ;4;30237;8;16;24;4;4;8;241896;483792;725688;120948
pas ;4;29643;7;13;20;4;4;8;207501;385359;592860;118572
ce ;3;29011;3;11;14;3;3;6;87033;319121;406154;87033
s ;2;28036;4;3;7;2;2;4;112144;84108;196252;56072
elle ;5;27267;7;21;28;5;5;10;190869;572607;763476;136335
avec ;5;26472;7;18;25;5;5;10;185304;476496;661800;132360
qu ;3;25763;6;14;20;3;3;6;154578;360682;515260;77289
mais ;5;25550;9;11;20;5;5;10;229950;281050;511000;127750
ne ;3;24536;4;13;17;3;3;6;98144;318968;417112;73608
comme ;6;22075;9;28;37;6;6;12;198675;618100;816775;132450
n ;2;21546;3;7;10;2;2;4;64638;150822;215460;43092
sa ;3;18696;5;5;10;3;3;6;93480;93480;186960;56088
ils ;4;17444;8;8;16;4;4;8;139552;139552;279104;69776
ont ;4;17423;8;17;25;4;4;8;139384;296191;435575;69692
ete ;4;17041;6;16;22;4;4;8;102246;272656;374902;68164
y ;2;16352;4;9;13;2;2;4;65408;147168;212576;32704
aux ;4;16302;8;14;22;4;4;8;130416;228228;358644;65208
tres ;5;16228;11;13;24;5;5;10;178508;210964;389472;81140
aussi ;6;15694;13;12;25;6;6;12;204022;188328;392350;94164
ses ;4;15661;8;11;19;4;4;8;125288;172271;297559;62644
cette ;6;15351;10;23;33;6;6;12;153510;353073;506583;92106
fait ;5;14532;8;14;22;5;5;10;116256;203448;319704;72660
peut ;5;13949;10;22;32;5;5;10;139490;306878;446368;69745
leur ;5;13586;10;16;26;5;5;10;135860;217376;353236;67930
deux ;5;13274;9;23;32;5;5;10;119466;305302;424768;66370
etre ;5;13146;9;17;26;5;5;10;118314;223482;341796;65730
meme ;5;12315;7;23;30;5;5;10;86205;283245;369450;61575
etait ;6;11616;11;16;27;6;6;12;127776;185856;313632;69696
entre ;6;11581;11;23;34;6;6;12;127391;266363;393754;69486
je ;3;11517;4;9;13;3;3;6;46068;103653;149721;34551
france ;7;10672;10;27;37;7;7;14;106720;288144;394864;74704
apres ;6;10577;11;20;31;6;6;12;116347;211540;327887;63462
autres ;7;10414;15;19;34;7;7;14;156210;197866;354076;72898
pays ;5;10308;10;21;31;5;5;10;103080;216468;319548;51540
ces ;4;10300;6;13;19;4;4;8;61800;133900;195700;41200
ans ;4;10179;7;11;18;4;4;8;71253;111969;183222;40716
lui ;4;10160;8;10;18;4;4;8;81280;101600;182880;40640
o ;2;9817;3;8;11;2;2;4;29451;78536;107987;19634
alors ;6;9631;12;17;29;6;6;12;115572;163727;279299;57786
faire ;6;9379;9;18;27;6;6;12;84411;168822;253233;56274
si ;3;9322;6;4;10;3;3;6;55932;37288;93220;27966
tout ;5;9271;12;18;30;5;5;10;111252;166878;278130;46355
j ;2;9028;3;3;6;2;2;4;27084;27084;54168;18056
bien ;5;8969;7;17;24;5;5;10;62783;152473;215256;44845
donc ;5;8648;7;23;30;5;5;10;60536;198904;259440;43240
ville ;6;8242;11;21;32;6;6;12;90662;173082;263744;49452
sous ;5;8064;12;16;28;5;5;10;96768;129024;225792;40320
monde ;6;7979;9;30;39;6;6;12;71811;239370;311181;47874
roi ;4;7628;8;10;18;4;4;8;61024;76280;137304;30512
nom ;4;7508;7;19;26;4;4;8;52556;142652;195208;30032
guerre ;7;7165;13;27;40;7;7;14;93145;193455;286600;50155
siecle ;7;7152;11;24;35;7;7;14;78672;171648;250320;50064
tous ;5;7150;12;17;29;5;5;10;85800;121550;207350;35750
partie ;7;7136;13;22;35;7;7;14;92768;156992;249760;49952
plusieurs ;10;6946;23;33;56;10;10;20;159758;229218;388976;69460
depuis ;7;6924;13;27;40;7;7;14;90012;186948;276960;48468
dont ;5;6896;9;22;31;5;5;10;62064;151712;213776;34480
contre ;7;6824;13;28;41;7;7;14;88712;191072;279784;47768
beaucoup ;9;6674;15;39;54;9;9;18;100110;260286;360396;60066
ainsi ;6;6582;11;13;24;6;6;12;72402;85566;157968;39492
leurs ;6;6562;13;18;31;6;6;12;85306;118116;203422;39372
pendant ;8;6537;13;37;50;8;8;16;84981;241869;326850;52296
puis ;5;6508;11;16;27;5;5;10;71588;104128;175716;32540
grand ;6;6287;9;23;32;6;6;12;56583;144601;201184;37722
car ;4;6265;6;8;14;4;4;8;37590;50120;87710;25060
peu ;4;6180;7;19;26;4;4;8;43260;117420;160680;24720
avoir ;6;6113;12;17;29;6;6;12;73356;103921;177277;36678
grande ;7;6074;10;29;39;7;7;14;60740;176146;236886;42518
t ;2;6042;4;4;8;2;2;4;24168;24168;48336;12084
tu ;3;5996;7;8;15;3;3;6;41972;47968;89940;17988
egalement ;10;5973;15;47;62;10;10;20;89595;280731;370326;59730
sans ;5;5962;10;13;23;5;5;10;59620;77506;137126;29810
nord ;5;5949;9;20;29;5;5;10;53541;118980;172521;29745
sud ;4;5944;8;12;20;4;4;8;47552;71328;118880;23776
souvent ;8;5906;18;34;52;8;8;16;106308;200804;307112;47248
francais ;9;5880;15;26;41;9;9;18;88200;152880;241080;52920
avant ;6;5756;11;19;30;6;6;12;63316;109364;172680;34536
exemple ;8;5715;13;43;56;8;8;16;74295;245745;320040;45720
cela ;5;5619;6;17;23;5;5;10;33714;95523;129237;28095
encore ;7;5618;11;31;42;7;7;14;61798;174158;235956;39326
jusqu ;6;5599;14;22;36;6;6;12;78386;123178;201564;33594
fois ;5;5568;9;18;27;5;5;10;50112;100224;150336;27840
temps ;6;5539;12;25;37;6;6;12;66468;138475;204943;33234
eau ;4;5501;6;13;19;4;4;8;33006;71513;104519;22004
premier ;8;5399;15;29;44;8;8;16;80985;156571;237556;43192
elles ;6;5315;10;23;33;6;6;12;53150;122245;175395;31890
nous ;5;5290;11;20;31;5;5;10;58190;105800;163990;26450
vers ;5;5257;11;15;26;5;5;10;57827;78855;136682;26285
dire ;5;5243;8;14;22;5;5;10;41944;73402;115346;26215
autre ;6;5155;12;17;29;6;6;12;61860;87635;149495;30930
vie ;4;5033;7;13;20;4;4;8;35231;65429;100660;20132
mort ;5;5033;11;17;28;5;5;10;55363;85561;140924;25165
trois ;6;4965;14;15;29;6;6;12;69510;74475;143985;29790
avait ;6;4938;11;14;25;6;6;12;54318;69132;123450;29628
m ;2;4929;3;6;9;2;2;4;14787;29574;44361;9858
premiere ;9;4885;16;35;51;9;9;18;78160;170975;249135;43965
moins ;6;4855;12;22;34;6;6;12;58260;106810;165070;29130
certains ;9;4815;17;26;43;9;9;18;81855;125190;207045;43335
annees ;7;4804;11;29;40;7;7;14;52844;139316;192160;33628
cet ;4;4792;6;14;20;4;4;8;28752;67088;95840;19168
peuvent ;8;4739;16;39;55;8;8;16;75824;184821;260645;37912
paris ;6;4580;12;15;27;6;6;12;54960;68700;123660;27480
fin ;4;4441;6;15;21;4;4;8;26646;66615;93261;17764
quand ;6;4420;10;27;37;6;6;12;44200;119340;163540;26520
personnes ;10;4306;20;45;65;10;10;20;86120;193770;279890;43060
vous ;5;4254;12;19;31;5;5;10;51048;80826;131874;21270
etaient ;8;4244;14;28;42;8;8;16;59416;118832;178248;33952
lieu ;5;4206;9;16;25;5;5;10;37854;67296;105150;21030
ai ;3;4152;4;4;8;3;3;6;16608;16608;33216;12456
doit ;5;4141;9;17;26;5;5;10;37269;70397;107666;20705
terre ;6;4134;12;18;30;6;6;12;49608;74412;124020;24804
trouve ;7;4133;16;27;43;7;7;14;66128;111591;177719;28931
etat ;5;4129;9;15;24;5;5;10;37161;61935;99096;20645
e ;2;4058;2;7;9;2;2;4;8116;28406;36522;8116
faut ;5;4051;9;17;26;5;5;10;36459;68867;105326;20255
nombreux ;9;4048;18;40;58;9;9;18;72864;161920;234784;36432
soit ;5;4037;11;14;25;5;5;10;44407;56518;100925;20185
vikidia ;8;4014;14;19;33;8;8;16;56196;76266;132462;32112
quelques ;9;4005;18;45;63;9;9;18;72090;180225;252315;36045
chaque ;7;4001;10;35;45;7;7;14;40010;140035;180045;28007
annee ;6;3983;8;27;35;6;6;12;31864;107541;139405;23898
europe ;7;3982;13;33;46;7;7;14;51766;131406;183172;27874
environ ;8;3972;16;33;49;8;8;16;63552;131076;194628;31776
non ;4;3971;7;20;27;4;4;8;27797;79420;107217;15884
devient ;8;3965;14;33;47;8;8;16;55510;130845;186355;31720
fut ;4;3909;8;15;23;4;4;8;31272;58635;89907;15636
saint ;6;3907;12;15;27;6;6;12;46884;58605;105489;23442
enfants ;8;3894;14;33;47;8;8;16;54516;128502;183018;31152
existe ;7;3881;14;26;40;7;7;14;54334;100906;155240;27167
etats ;6;3856;12;17;29;6;6;12;46272;65552;111824;23136
celui ;6;3828;10;20;30;6;6;12;38280;76560;114840;22968
selon ;6;3821;11;26;37;6;6;12;42031;99346;141377;22926
cas ;4;3800;6;9;15;4;4;8;22800;34200;57000;15200
ci ;3;3762;4;6;10;3;3;6;15048;22572;37620;11286
pouvoir ;8;3692;18;34;52;8;8;16;66456;125528;191984;29536
famille ;8;3687;12;30;42;8;8;16;44244;110610;154854;29496
forme ;6;3674;10;27;37;6;6;12;36740;99198;135938;22044
lors ;5;3644;11;15;26;5;5;10;40084;54660;94744;18220
fils ;5;3609;9;15;24;5;5;10;32481;54135;86616;18045
va ;3;3583;5;8;13;3;3;6;17915;28664;46579;10749
empire ;7;3559;12;28;40;7;7;14;42708;99652;142360;24913
place ;6;3539;8;25;33;6;6;12;28312;88475;116787;21234
nombre ;7;3534;12;29;41;7;7;14;42408;102486;144894;24738
partir ;7;3507;15;17;32;7;7;14;52605;59619;112224;24549
francaise ;10;3506;16;32;48;10;10;20;56096;112192;168288;35060
hui ;4;3495;7;15;22;4;4;8;24465;52425;76890;13980
aujourd ;8;3487;16;26;42;8;8;16;55792;90662;146454;27896
permet ;7;3471;13;30;43;7;7;14;45123;104130;149253;24297
histoire ;9;3413;18;31;49;9;9;18;61434;105803;167237;30717
toutes ;7;3380;16;26;42;7;7;14;54080;87880;141960;23660
notamment ;10;3369;19;44;63;10;10;20;64011;148236;212247;33690
mer ;4;3366;7;13;20;4;4;8;23562;43758;67320;13464
royaume ;8;3360;16;34;50;8;8;16;53760;114240;168000;26880
jours ;6;3343;14;17;31;6;6;12;46802;56831;103633;20058
grace ;6;3343;8;22;30;6;6;12;26744;73546;100290;20058
habitants ;10;3290;18;32;50;10;10;20;59220;105280;164500;32900
cours ;6;3260;13;19;32;6;6;12;42380;61940;104320;19560
jour ;5;3258;11;15;26;5;5;10;35838;48870;84708;16290
me ;3;3237;4;12;16;3;3;6;12948;38844;51792;9711
homme ;6;3232;9;33;42;6;6;12;29088;106656;135744;19392
armee ;6;3220;9;21;30;6;6;12;28980;67620;96600;19320
toujours ;9;3200;22;31;53;9;9;18;70400;99200;169600;28800
petit ;6;3191;12;22;34;6;6;12;38292;70202;108494;19146
region ;7;3179;12;30;42;7;7;14;38148;95370;133518;22253
unis ;5;3165;11;14;25;5;5;10;34815;44310;79125;15825
celle ;6;3159;8;25;33;6;6;12;25272;78975;104247;18954
discussion ;11;3156;23;35;58;11;11;22;72588;110460;183048;34716
pres ;5;3147;10;18;28;5;5;10;31470;56646;88116;15735
h ;2;3115;2;10;12;2;2;4;6230;31150;37380;6230
sera ;5;3114;9;12;21;5;5;10;28026;37368;65394;15570
politique ;10;3111;20;44;64;10;10;20;62220;136884;199104;31110
km ;3;3101;5;9;14;3;3;6;15505;27909;43414;9303
surtout ;8;3087;21;25;46;8;8;16;64827;77175;142002;24696
ne ;3;3058;4;13;17;3;3;6;12232;39754;51986;9174
epoque ;7;3047;12;41;53;7;7;14;36564;124927;161491;21329
effet ;6;3043;8;30;38;6;6;12;24344;91290;115634;18258
gouvernement ;13;3037;25;64;89;13;13;26;75925;194368;270293;39481
animaux ;8;3033;15;28;43;8;8;16;45495;84924;130419;24264
debut ;6;3019;10;22;32;6;6;12;30190;66418;96608;18114
cependant ;10;3018;15;47;62;10;10;20;45270;141846;187116;30180
ouest ;6;2997;13;23;36;6;6;12;38961;68931;107892;17982
mars ;5;2986;10;11;21;5;5;10;29860;32846;62706;14930
age ;4;2958;4;17;21;4;4;8;11832;50286;62118;11832
louis ;6;2947;13;19;32;6;6;12;38311;55993;94304;17682
mai ;4;2914;6;9;15;4;4;8;17484;26226;43710;11656
toute ;6;2905;13;24;37;6;6;12;37765;69720;107485;17430
afin ;5;2886;7;17;24;5;5;10;20202;49062;69264;14430
population ;11;2880;22;51;73;11;11;22;63360;146880;210240;31680
compte ;7;2868;12;34;46;7;7;14;34416;97512;131928;20076
pere ;5;2868;8;22;30;5;5;10;22944;63096;86040;14340
te ;3;2851;5;10;15;3;3;6;14255;28510;42765;8553
juin ;5;2850;10;14;24;5;5;10;28500;39900;68400;14250
hommes ;7;2849;12;35;47;7;7;14;34188;99715;133903;19943
eux ;4;2837;8;18;26;4;4;8;22696;51066;73762;11348
president ;10;2820;19;39;58;10;10;20;53580;109980;163560;28200
voir ;5;2805;11;15;26;5;5;10;30855;42075;72930;14025
mois ;5;2804;10;16;26;5;5;10;28040;44864;72904;14020
suite ;6;2791;13;17;30;6;6;12;36283;47447;83730;16746
nombreuses ;11;2788;22;43;65;11;11;22;61336;119884;181220;30668
nouveau ;8;2785;16;35;51;8;8;16;44560;97475;142035;22280
corps ;6;2756;12;23;35;6;6;12;33072;63388;96460;16536
parfois ;8;2751;15;29;44;8;8;16;41265;79779;121044;22008
octobre ;8;2732;14;32;46;8;8;16;38248;87424;125672;21856
ile ;4;2730;6;12;18;4;4;8;16380;32760;49140;10920
cest ;5;2727;9;16;25;5;5;10;24543;43632;68175;13635
ceux ;5;2718;9;22;31;5;5;10;24462;59796;84258;13590
millions ;9;2717;18;31;49;9;9;18;48906;84227;133133;24453
groupe ;7;2712;13;35;48;7;7;14;35256;94920;130176;18984
republique ;11;2712;21;47;68;11;11;22;56952;127464;184416;29832
pourquoi ;9;2711;20;42;62;9;9;18;54220;113862;168082;24399
certaines ;10;2701;18;32;50;10;10;20;48618;86432;135050;27010
dit ;4;2699;7;10;17;4;4;8;18893;26990;45883;10796
janvier ;8;2682;15;24;39;8;8;16;40230;64368;104598;21456
reste ;6;2673;12;19;31;6;6;12;32076;50787;82863;16038
septembre ;10;2648;18;41;59;10;10;20;47664;108568;156232;26480
nouvelle ;9;2641;17;43;60;9;9;18;44897;113563;158460;23769
grands ;7;2632;12;25;37;7;7;14;31584;65800;97384;18424
des ;4;2626;6;14;20;4;4;8;15756;36764;52520;10504
trop ;5;2618;11;20;31;5;5;10;28798;52360;81158;13090
ensuite ;8;2614;16;29;45;8;8;16;41824;75806;117630;20912
personne ;9;2608;17;43;60;9;9;18;44336;112144;156480;23472
chez ;5;2602;7;29;36;5;5;10;18214;75458;93672;13010
quatre ;7;2587;14;26;40;7;7;14;36218;67262;103480;18109
origine ;8;2580;14;31;45;8;8;16;36120;79980;116100;20640
la ;3;2559;4;7;11;3;3;6;10236;17913;28149;7677
r ;2;2550;4;2;6;2;2;4;10200;5100;15300;5100
allemagne ;10;2546;14;44;58;10;10;20;35644;112024;147668;25460
empereur ;9;2519;17;38;55;9;9;18;42823;95722;138545;22671
article ;8;2515;14;22;36;8;8;16;35210;55330;90540;20120
appelle ;8;2496;12;39;51;8;8;16;29952;97344;127296;19968
general ;8;2495;12;34;46;8;8;16;29940;84830;114770;19960
eu ;3;2492;5;11;16;3;3;6;12460;27412;39872;7476
b ;2;2477;2;4;6;2;2;4;4954;9908;14862;4954
font ;5;2476;9;24;33;5;5;10;22284;59424;81708;12380
jeu ;4;2464;7;13;20;4;4;8;17248;32032;49280;9856
juillet ;8;2463;16;25;41;8;8;16;39408;61575;100983;19704
avril ;6;2456;12;14;26;6;6;12;29472;34384;63856;14736
deja ;5;2443;6;16;22;5;5;10;14658;39088;53746;12215
ca ;3;2400;3;7;10;3;3;6;7200;16800;24000;7200
suis ;5;2398;12;10;22;5;5;10;28776;23980;52756;11990
capitale ;9;2393;14;31;45;9;9;18;33502;74183;107685;21537
centre ;7;2340;12;27;39;7;7;14;28080;63180;91260;16380
petits ;7;2331;15;24;39;7;7;14;34965;55944;90909;16317
veut ;5;2329;11;19;30;5;5;10;25619;44251;69870;11645
tard ;5;2312;9;12;21;5;5;10;20808;27744;48552;11560
anglais ;8;2305;13;26;39;8;8;16;29965;59930;89895;18440
site ;5;2292;10;13;23;5;5;10;22920;29796;52716;11460
tour ;5;2290;12;16;28;5;5;10;27480;36640;64120;11450
ii ;3;2284;5;3;8;3;3;6;11420;6852;18272;6852
droit ;6;2280;12;18;30;6;6;12;27360;41040;68400;13680
etant ;6;2271;11;21;32;6;6;12;24981;47691;72672;13626
dernier ;8;2256;14;27;41;8;8;16;31584;60912;92496;18048
ensemble ;9;2216;14;39;53;9;9;18;31024;86424;117448;19944
especes ;8;2215;13;35;48;8;8;16;28795;77525;106320;17720
decembre ;9;2210;12;37;49;9;9;18;26520;81770;108290;19890
novembre ;9;2205;16;40;56;9;9;18;35280;88200;123480;19845
seul ;5;2202;10;17;27;5;5;10;22020;37434;59454;11010
fevrier ;8;2200;15;28;43;8;8;16;33000;61600;94600;17600
point ;6;2188;12;26;38;6;6;12;26256;56888;83144;13128
langue ;7;2188;11;31;42;7;7;14;24068;67828;91896;15316
aout ;5;2187;10;17;27;5;5;10;21870;37179;59049;10935
italie ;7;2185;12;18;30;7;7;14;26220;39330;65550;15295
jean ;5;2183;7;17;24;5;5;10;15281;37111;52392;10915
notre ;6;2171;12;24;36;6;6;12;26052;52104;78156;13026
travail ;8;2169;16;19;35;8;8;16;34704;41211;75915;17352
grandes ;8;2166;13;31;44;8;8;16;28158;67146;95304;17328
merci ;6;2152;10;18;28;6;6;12;21520;38736;60256;12912
assez ;6;2145;12;22;34;6;6;12;25740;47190;72930;12870
or ;3;2133;6;9;15;3;3;6;12798;19197;31995;6399
ecole ;6;2132;8;28;36;6;6;12;17056;59696;76752;12792
systeme ;8;2124;17;33;50;8;8;16;36108;70092;106200;16992
serie ;6;2116;11;17;28;6;6;12;23276;35972;59248;12696
long ;5;2098;8;26;34;5;5;10;16784;54548;71332;10490
moyen ;6;2080;11;33;44;6;6;12;22880;68640;91520;12480
parti ;6;2070;12;16;28;6;6;12;24840;33120;57960;12420
mere ;5;2070;8;19;27;5;5;10;16560;39330;55890;10350
ier ;4;2068;7;9;16;4;4;8;14476;18612;33088;8272
periode ;8;2062;13;35;48;8;8;16;26806;72170;98976;16496
durant ;7;2057;14;22;36;7;7;14;28798;45254;74052;14399
agit ;5;2050;8;15;23;5;5;10;16400;30750;47150;10250
differentes ;12;2044;20;51;71;12;12;24;40880;104244;145124;24528
ayant ;6;2034;11;22;33;6;6;12;22374;44748;67122;12204
jeux ;5;2020;10;20;30;5;5;10;20200;40400;60600;10100
bonjour ;8;2017;16;31;47;8;8;16;32272;62527;94799;16136
afrique ;8;2003;14;31;45;8;8;16;28042;62093;90135;16024
chef ;5;1984;5;27;32;5;5;10;9920;53568;63488;9920
autour ;7;1982;16;22;38;7;7;14;31712;43604;75316;13874
differents ;11;1973;19;45;64;11;11;22;37487;88785;126272;21703
generalement ;13;1972;21;60;81;13;13;26;41412;118320;159732;25636
x ;2;1968;4;8;12;2;2;4;7872;15744;23616;3936
page ;5;1967;6;25;31;5;5;10;11802;49175;60977;9835
charles ;8;1966;13;29;42;8;8;16;25558;57014;82572;15728
plupart ;8;1963;17;31;48;8;8;16;33371;60853;94224;15704
doivent ;8;1962;15;34;49;8;8;16;29430;66708;96138;15696
jeune ;6;1960;10;25;35;6;6;12;19600;49000;68600;11760
tete ;5;1958;9;19;28;5;5;10;17622;37202;54824;9790
mondiale ;9;1955;14;37;51;9;9;18;27370;72335;99705;17595
villes ;7;1953;14;23;37;7;7;14;27342;44919;72261;13671
rome ;5;1953;9;20;29;5;5;10;17577;39060;56637;9765
mot ;4;1952;8;16;24;4;4;8;15616;31232;46848;7808
part ;5;1952;10;15;25;5;5;10;19520;29280;48800;9760
seconde ;8;1952;12;37;49;8;8;16;23424;72224;95648;15616
petite ;7;1943;13;28;41;7;7;14;25259;54404;79663;13601
metres ;7;1935;14;24;38;7;7;14;27090;46440;73530;13545
dieu ;5;1929;8;17;25;5;5;10;15432;32793;48225;9645
femmes ;7;1924;11;32;43;7;7;14;21164;61568;82732;13468
face ;5;1923;5;20;25;5;5;10;9615;38460;48075;9615
belgique ;9;1890;14;42;56;9;9;18;26460;79380;105840;17010
cause ;6;1889;10;19;29;6;6;12;18890;35891;54781;11334
musique ;8;1888;17;32;49;8;8;16;32096;60416;92512;15104
situee ;7;1886;14;23;37;7;7;14;26404;43378;69782;13202
jeunes ;7;1876;13;27;40;7;7;14;24388;50652;75040;13132
ur ;3;1868;7;6;13;3;3;6;13076;11208;24284;5604
haut ;5;1865;9;19;28;5;5;10;16785;35435;52220;9325
appele ;7;1865;10;35;45;7;7;14;18650;65275;83925;13055
aide ;5;1865;6;15;21;5;5;10;11190;27975;39165;9325
donne ;6;1856;9;31;40;6;6;12;16704;57536;74240;11136
pierre ;7;1848;13;24;37;7;7;14;24024;44352;68376;12936
av ;3;1848;5;8;13;3;3;6;9240;14784;24024;5544
ancien ;7;1846;10;26;36;7;7;14;18460;47996;66456;12922
moment ;7;1846;13;33;46;7;7;14;23998;60918;84916;12922
equipe ;7;1831;12;35;47;7;7;14;21972;64085;86057;12817
ailleurs ;9;1828;18;25;43;9;9;18;32904;45700;78604;16452
russie ;7;1827;16;17;33;7;7;14;29232;31059;60291;12789
important ;10;1822;21;37;58;10;10;20;38262;67414;105676;18220
soleil ;7;1816;13;25;38;7;7;14;23608;45400;69008;12712
regions ;8;1815;15;32;47;8;8;16;27225;58080;85305;14520
utilise ;8;1811;17;22;39;8;8;16;30787;39842;70629;14488
avaient ;8;1802;14;26;40;8;8;16;25228;46852;72080;14416
deuxieme ;9;1801;15;41;56;9;9;18;27015;73841;100856;16209
connu ;6;1801;11;28;39;6;6;12;19811;50428;70239;10806
jamais ;7;1789;12;15;27;7;7;14;21468;26835;48303;12523
parmi ;6;1784;11;18;29;6;6;12;19624;32112;51736;10704
mon ;4;1783;7;19;26;4;4;8;12481;33877;46358;7132
lorsque ;8;1780;17;34;51;8;8;16;30260;60520;90780;14240
ordre ;6;1778;11;21;32;6;6;12;19558;37338;56896;10668
passe ;6;1778;11;21;32;6;6;12;19558;37338;56896;10668
etc ;4;1773;6;14;20;4;4;8;10638;24822;35460;7092
comment ;8;1762;14;37;51;8;8;16;24668;65194;89862;14096
espagne ;8;1757;12;39;51;8;8;16;21084;68523;89607;14056
fille ;6;1751;9;23;32;6;6;12;15759;40273;56032;10506
film ;5;1741;8;18;26;5;5;10;13928;31338;45266;8705
bois ;5;1738;9;14;23;5;5;10;15642;24332;39974;8690
possible ;9;1735;17;34;51;9;9;18;29495;58990;88485;15615
particulier ;12;1721;24;36;60;12;12;24;41304;61956;103260;20652
an ;3;1718;4;9;13;3;3;6;6872;15462;22334;5154
ecrit ;6;1706;11;16;27;6;6;12;18766;27296;46062;10236
angleterre ;11;1703;19;44;63;11;11;22;32357;74932;107289;18733
vient ;6;1702;12;22;34;6;6;12;20424;37444;57868;10212
donne ;6;1702;9;31;40;6;6;12;15318;52762;68080;10212
premiers ;9;1700;18;31;49;9;9;18;30600;52700;83300;15300
niveau ;7;1697;13;25;38;7;7;14;22061;42425;64486;11879
articles ;9;1696;17;24;41;9;9;18;28832;40704;69536;15264
but ;4;1691;8;11;19;4;4;8;13528;18601;32129;6764
bas ;4;1688;6;8;14;4;4;8;10128;13504;23632;6752
territoire ;11;1682;24;31;55;11;11;22;40368;52142;92510;18502
mettre ;7;1681;14;25;39;7;7;14;23534;42025;65559;11767
lorsqu ;7;1672;16;28;44;7;7;14;26752;46816;73568;11704
prend ;6;1669;10;27;37;6;6;12;16690;45063;61753;10014
vit ;4;1667;9;10;19;4;4;8;15003;16670;31673;6668
amerique ;9;1666;16;35;51;9;9;18;26656;58310;84966;14994
titre ;6;1663;13;15;28;6;6;12;21619;24945;46564;9978
membres ;8;1656;14;29;43;8;8;16;23184;48024;71208;13248
prix ;5;1650;11;18;29;5;5;10;18150;29700;47850;8250
hiver ;6;1647;11;23;34;6;6;12;18117;37881;55998;9882
demande ;8;1646;10;36;46;8;8;16;16460;59256;75716;13168
contr ;6;1644;12;22;34;6;6;12;19728;36168;55896;9864
femme ;6;1644;8;30;38;6;6;12;13152;49320;62472;9864
commence ;9;1642;13;44;57;9;9;18;21346;72248;93594;14778
cree ;5;1640;7;18;25;5;5;10;11480;29520;41000;8200
eglise ;7;1639;11;28;39;7;7;14;18029;45892;63921;11473
seulement ;10;1635;19;43;62;10;10;20;31065;70305;101370;16350
vont ;5;1633;11;22;33;5;5;10;17963;35926;53889;8165
te ;3;1632;5;10;15;3;3;6;8160;16320;24480;4896
parce ;6;1623;9;22;31;6;6;12;14607;35706;50313;9738
revolution ;11;1603;24;45;69;11;11;22;38472;72135;110607;17633
bon ;4;1598;6;17;23;4;4;8;9588;27166;36754;6392
parents ;8;1592;16;29;45;8;8;16;25472;46168;71640;12736
lumiere ;8;1590;15;28;43;8;8;16;23850;44520;68370;12720
porte ;6;1589;12;26;38;6;6;12;19068;41314;60382;9534
question ;9;1576;19;39;58;9;9;18;29944;61464;91408;14184
aurait ;7;1573;14;14;28;7;7;14;22022;22022;44044;11011
cinq ;5;1571;8;21;29;5;5;10;12568;32991;45559;7855
possede ;8;1566;14;37;51;8;8;16;21924;57942;79866;12528
college ;8;1563;11;40;51;8;8;16;17193;62520;79713;12504
prendre ;8;1559;14;34;48;8;8;16;21826;53006;74832;12472
fonction ;9;1557;16;42;58;9;9;18;24912;65394;90306;14013
rouge ;6;1555;11;27;38;6;6;12;17105;41985;59090;9330
the ;4;1555;6;19;25;4;4;8;9330;29545;38875;6220
mouvement ;10;1548;20;48;68;10;10;20;30960;74304;105264;15480
tes ;4;1546;8;12;20;4;4;8;12368;18552;30920;6184
seule ;6;1543;11;23;34;6;6;12;16973;35489;52462;9258
departement ;12;1543;21;52;73;12;12;24;32403;80236;112639;18516
couleur ;8;1539;16;31;47;8;8;16;24624;47709;72333;12312
ministre ;9;1533;19;26;45;9;9;18;29127;39858;68985;13797
ligne ;6;1530;9;26;35;6;6;12;13770;39780;53550;9180
devant ;7;1516;12;28;40;7;7;14;18192;42448;60640;10612
romain ;7;1513;13;23;36;7;7;14;19669;34799;54468;10591
succes ;7;1507;13;23;36;7;7;14;19591;34661;54252;10549
mieux ;6;1505;12;24;36;6;6;12;18060;36120;54180;9030
militaire ;10;1503;19;25;44;10;10;20;28557;37575;66132;15030
creer ;6;1501;10;19;29;6;6;12;15010;28519;43529;9006
moi ;4;1495;7;14;21;4;4;8;10465;20930;31395;5980
bonne ;6;1488;9;29;38;6;6;12;13392;43152;56544;8928
mis ;4;1487;8;9;17;4;4;8;11896;13383;25279;5948
chine ;6;1487;8;27;35;6;6;12;11896;40149;52045;8922
abord ;6;1486;9;19;28;6;6;12;13374;28234;41608;8916
savoir ;7;1484;15;19;34;7;7;14;22260;28196;50456;10388
mesure ;7;1482;14;25;39;7;7;14;20748;37050;57798;10374
taille ;7;1481;12;21;33;7;7;14;17772;31101;48873;10367
serait ;7;1481;14;16;30;7;7;14;20734;23696;44430;10367
air ;4;1477;7;5;12;4;4;8;10339;7385;17724;5908
situe ;6;1475;13;17;30;6;6;12;19175;25075;44250;8850
ni ;3;1475;5;8;13;3;3;6;7375;11800;19175;4425
nos ;4;1475;8;16;24;4;4;8;11800;23600;35400;5900
bataille ;9;1475;14;26;40;9;9;18;20650;38350;59000;13275
malgre ;7;1474;11;27;38;7;7;14;16214;39798;56012;10318
milieu ;7;1469;13;22;35;7;7;14;19097;32318;51415;10283
met ;4;1457;7;15;22;4;4;8;10199;21855;32054;5828
raison ;7;1455;14;20;34;7;7;14;20370;29100;49470;10185
mal ;4;1455;6;12;18;4;4;8;8730;17460;26190;5820
donner ;7;1447;12;32;44;7;7;14;17364;46304;63668;10129
union ;6;1446;12;25;37;6;6;12;17352;36150;53502;8676
enfant ;7;1441;11;31;42;7;7;14;15851;44671;60522;10087
produit ;8;1440;17;30;47;8;8;16;24480;43200;67680;11520
animal ;7;1440;11;21;32;7;7;14;15840;30240;46080;10080
trouver ;8;1435;19;28;47;8;8;16;27265;40180;67445;11480
sol ;4;1432;8;14;22;4;4;8;11456;20048;31504;5728
theatre ;8;1429;14;31;45;8;8;16;20006;44299;64305;11432
aller ;6;1429;10;18;28;6;6;12;14290;25722;40012;8574
rien ;5;1428;9;15;24;5;5;10;12852;21420;34272;7140
type ;5;1422;10;26;36;5;5;10;14220;36972;51192;7110
maison ;7;1420;13;24;37;7;7;14;18460;34080;52540;9940
livre ;6;1420;12;18;30;6;6;12;17040;25560;42600;8520
ma ;3;1407;4;8;12;3;3;6;5628;11256;16884;4221
energie ;8;1406;12;35;47;8;8;16;16872;49210;66082;11248
vu ;3;1405;7;10;17;3;3;6;9835;14050;23885;4215
soldats ;8;1403;16;26;42;8;8;16;22448;36478;58926;11224
palais ;7;1403;12;20;32;7;7;14;16836;28060;44896;9821
napoleon ;9;1401;15;47;62;9;9;18;21015;65847;86862;12609
frere ;6;1398;10;22;32;6;6;12;13980;30756;44736;8388
commune ;8;1391;14;38;52;8;8;16;19474;52858;72332;11128
importante ;11;1389;22;43;65;11;11;22;30558;59727;90285;15279
espace ;7;1386;10;29;39;7;7;14;13860;40194;54054;9702
celebre ;8;1382;11;31;42;8;8;16;15202;42842;58044;11056
loi ;4;1381;7;13;20;4;4;8;9667;17953;27620;5524
chateau ;8;1380;12;31;43;8;8;16;16560;42780;59340;11040
as ;3;1378;5;5;10;3;3;6;6890;6890;13780;4134
base ;5;1373;7;14;21;5;5;10;9611;19222;28833;6865
meurt ;6;1373;13;20;33;6;6;12;17849;27460;45309;8238
parle ;6;1367;10;22;32;6;6;12;13670;30074;43744;8202
gens ;5;1366;8;23;31;5;5;10;10928;31418;42346;6830
art ;4;1365;8;7;15;4;4;8;10920;9555;20475;5460
plut ;5;1362;11;20;31;5;5;10;14982;27240;42222;6810
marie ;6;1352;10;16;26;6;6;12;13520;21632;35152;8112
films ;6;1348;11;20;31;6;6;12;14828;26960;41788;8088
argent ;7;1343;12;27;39;7;7;14;16116;36261;52377;9401
droite ;7;1342;13;24;37;7;7;14;17446;32208;49654;9394
mes ;4;1342;7;14;21;4;4;8;9394;18788;28182;5368
ados ;5;1341;8;17;25;5;5;10;10728;22797;33525;6705
ici ;4;1341;6;7;13;4;4;8;8046;9387;17433;5364
devenir ;8;1339;14;31;45;8;8;16;18746;41509;60255;10712
chose ;6;1332;9;29;38;6;6;12;11988;38628;50616;7992
besoin ;7;1330;12;26;38;7;7;14;15960;34580;50540;9310
appelee ;8;1327;11;41;52;8;8;16;14597;54407;69004;10616
principalement ;15;1325;27;62;89;15;15;30;35775;82150;117925;19875
romains ;8;1322;16;25;41;8;8;16;21152;33050;54202;10576
longtemps ;10;1318;19;50;69;10;10;20;25042;65900;90942;13180
seront ;7;1318;15;26;41;7;7;14;19770;34268;54038;9226
coree ;6;1315;9;25;34;6;6;12;11835;32875;44710;7890
scientifique ;13;1315;24;51;75;13;13;26;31560;67065;98625;17095
espece ;7;1314;10;33;43;7;7;14;13140;43362;56502;9198
heures ;7;1313;13;29;42;7;7;14;17069;38077;55146;9191
laquelle ;9;1310;15;40;55;9;9;18;19650;52400;72050;11790
troisieme ;10;1310;20;33;53;10;10;20;26200;43230;69430;13100
uvre ;5;1310;11;17;28;5;5;10;14410;22270;36680;6550
rapidement ;11;1307;19;44;63;11;11;22;24833;57508;82341;14377
enfin ;6;1303;9;27;36;6;6;12;11727;35181;46908;7818
force ;6;1302;9;26;35;6;6;12;11718;33852;45570;7812
conseil ;8;1301;14;31;45;8;8;16;18214;40331;58545;10408
proche ;7;1300;11;36;47;7;7;14;14300;46800;61100;9100
duc ;4;1299;6;14;20;4;4;8;7794;18186;25980;5196
nomme ;6;1297;10;30;40;6;6;12;12970;38910;51880;7782
produits ;9;1296;20;32;52;9;9;18;25920;41472;67392;11664
vivent ;7;1294;15;27;42;7;7;14;19410;34938;54348;9058
societe ;8;1293;14;30;44;8;8;16;18102;38790;56892;10344
ton ;4;1287;8;17;25;4;4;8;10296;21879;32175;5148
texte ;6;1286;12;26;38;6;6;12;15432;33436;48868;7716
nationale ;10;1279;17;38;55;10;10;20;21743;48602;70345;12790
presente ;9;1277;17;39;56;9;9;18;21709;49803;71512;11493
plantes ;8;1275;15;32;47;8;8;16;19125;40800;59925;10200
vote ;5;1270;10;22;32;5;5;10;12700;27940;40640;6350
er ;3;1267;5;8;13;3;3;6;6335;10136;16471;3801
idee ;5;1263;6;19;25;5;5;10;7578;23997;31575;6315
allemand ;9;1257;13;35;48;9;9;18;16341;43995;60336;11313
parler ;7;1255;13;23;36;7;7;14;16315;28865;45180;8785
derniere ;9;1253;15;33;48;9;9;18;18795;41349;60144;11277
nouvelles ;10;1253;20;45;65;10;10;20;25060;56385;81445;12530
dessus ;7;1252;15;22;37;7;7;14;18780;27544;46324;8764
nuit ;5;1246;11;15;26;5;5;10;13706;18690;32396;6230
religion ;9;1241;16;35;51;9;9;18;19856;43435;63291;11169
saison ;7;1241;14;21;35;7;7;14;17374;26061;43435;8687
utilise ;8;1240;17;22;39;8;8;16;21080;27280;48360;9920
presque ;8;1240;16;37;53;8;8;16;19840;45880;65720;9920
rapport ;8;1239;17;31;48;8;8;16;21063;38409;59472;9912
public ;7;1238;12;25;37;7;7;14;14856;30950;45806;8666
japon ;6;1238;10;26;36;6;6;12;12380;32188;44568;7428
interieur ;10;1238;21;30;51;10;10;20;25998;37140;63138;12380
peuple ;7;1237;12;37;49;7;7;14;14844;45769;60613;8659
regime ;7;1237;11;28;39;7;7;14;13607;34636;48243;8659
maniere ;8;1233;13;28;41;8;8;16;16029;34524;50553;9864
arrive ;7;1231;14;17;31;7;7;14;17234;20927;38161;8617
reine ;6;1229;10;21;31;6;6;12;12290;25809;38099;7374
super ;6;1228;13;22;35;6;6;12;15964;27016;42980;7368
sert ;5;1227;11;13;24;5;5;10;13497;15951;29448;6135
passer ;7;1222;14;22;36;7;7;14;17108;26884;43992;8554
naissance ;10;1222;17;32;49;10;10;20;20774;39104;59878;12220
pris ;5;1221;11;13;24;5;5;10;13431;15873;29304;6105
plein ;6;1213;10;26;36;6;6;12;12130;31538;43668;7278
politiques ;11;1211;23;46;69;11;11;22;27853;55706;83559;13321
droits ;7;1207;15;20;35;7;7;14;18105;24140;42245;8449
eleves ;7;1205;12;30;42;7;7;14;14460;36150;50610;8435
pape ;5;1197;7;25;32;5;5;10;8379;29925;38304;5985
xixe ;5;1193;10;22;32;5;5;10;11930;26246;38176;5965
simple ;7;1192;13;27;40;7;7;14;15496;32184;47680;8344
tant ;5;1191;10;15;25;5;5;10;11910;17865;29775;5955
asie ;5;1186;8;12;20;5;5;10;9488;14232;23720;5930
latin ;6;1185;11;17;28;6;6;12;13035;20145;33180;7110
surface ;8;1185;14;27;41;8;8;16;16590;31995;48585;9480
autriche ;9;1184;16;31;47;9;9;18;18944;36704;55648;10656
education ;10;1183;17;39;56;10;10;20;20111;46137;66248;11830
europeenne ;11;1181;19;57;76;11;11;22;22439;67317;89756;12991
nouveaux ;9;1180;19;42;61;9;9;18;22420;49560;71980;10620
philippe ;9;1180;15;46;61;9;9;18;17700;54280;71980;10620
regne ;6;1180;9;28;37;6;6;12;10620;33040;43660;7080
sens ;5;1178;10;17;27;5;5;10;11780;20026;31806;5890
noir ;5;1172;10;16;26;5;5;10;11720;18752;30472;5860
points ;7;1171;15;28;43;7;7;14;17565;32788;50353;8197
utiliser ;9;1170;20;23;43;9;9;18;23400;26910;50310;10530
celles ;7;1168;11;27;38;7;7;14;12848;31536;44384;8176
service ;8;1166;15;26;41;8;8;16;17490;30316;47806;9328
memes ;6;1164;10;25;35;6;6;12;11640;29100;40740;6984
uni ;4;1162;8;12;20;4;4;8;9296;13944;23240;4648
iles ;5;1162;9;14;23;5;5;10;10458;16268;26726;5810
situation ;10;1161;22;30;52;10;10;20;25542;34830;60372;11610
construction ;13;1161;28;49;77;13;13;26;32508;56889;89397;15093
petites ;8;1159;16;30;46;8;8;16;18544;34770;53314;9272
projet ;7;1157;14;28;42;7;7;14;16198;32396;48594;8099
gros ;5;1156;10;19;29;5;5;10;11560;21964;33524;5780
signifie ;9;1151;15;33;48;9;9;18;17265;37983;55248;10359
photo ;6;1150;11;35;46;6;6;12;12650;40250;52900;6900
henri ;6;1147;10;24;34;6;6;12;11470;27528;38998;6882
vite ;5;1146;10;16;26;5;5;10;11460;18336;29796;5730
action ;7;1145;12;24;36;7;7;14;13740;27480;41220;8015
displaystyle ;13;1139;27;54;81;13;13;26;30753;61506;92259;14807
gauche ;7;1135;9;34;43;7;7;14;10215;38590;48805;7945
blanc ;6;1132;8;20;28;6;6;12;9056;22640;31696;6792
catholique ;11;1129;19;50;69;11;11;22;21451;56450;77901;12419
russe ;6;1125;14;16;30;6;6;12;15750;18000;33750;6750
musee ;6;1124;11;24;35;6;6;12;12364;26976;39340;6744
facon ;6;1123;8;27;35;6;6;12;8984;30321;39305;6738
americain ;10;1123;16;29;45;10;10;20;17968;32567;50535;11230
club ;5;1123;8;16;24;5;5;10;8984;17968;26952;5615
compose ;8;1117;14;40;54;8;8;16;15638;44680;60318;8936
rencontre ;10;1112;19;41;60;10;10;20;21128;45592;66720;11120
production ;11;1112;22;47;69;11;11;22;24464;52264;76728;12232
date ;5;1109;7;17;24;5;5;10;7763;18853;26616;5545
rendre ;7;1109;12;26;38;7;7;14;13308;28834;42142;7763
conditions ;11;1109;21;43;64;11;11;22;23289;47687;70976;12199
decide ;7;1109;8;28;36;7;7;14;8872;31052;39924;7763
retour ;7;1108;16;23;39;7;7;14;17728;25484;43212;7756
choses ;7;1106;12;31;43;7;7;14;13272;34286;47558;7742
vivre ;6;1105;13;19;32;6;6;12;14365;20995;35360;6630
semaine ;8;1101;13;29;42;8;8;16;14313;31929;46242;8808
coupe ;6;1099;10;30;40;6;6;12;10990;32970;43960;6594
objets ;7;1098;13;24;37;7;7;14;14274;26352;40626;7686
fort ;5;1096;10;19;29;5;5;10;10960;20824;31784;5480
construit ;10;1093;23;32;55;10;10;20;25139;34976;60115;10930
cm ;3;1092;4;10;14;3;3;6;4368;10920;15288;3276
allemands ;10;1091;16;37;53;10;10;20;17456;40367;57823;10910
terme ;6;1084;11;22;33;6;6;12;11924;23848;35772;6504
pu ;3;1084;6;13;19;3;3;6;6504;14092;20596;3252
personnage ;11;1078;19;53;72;11;11;22;20482;57134;77616;11858
grec ;5;1078;7;20;27;5;5;10;7546;21560;29106;5390
culture ;8;1078;17;27;44;8;8;16;18326;29106;47432;8624
creation ;9;1077;16;31;47;9;9;18;17232;33387;50619;9693
main ;5;1075;8;15;23;5;5;10;8600;16125;24725;5375
appeles ;8;1073;13;37;50;8;8;16;13949;39701;53650;8584
voit ;5;1067;11;17;28;5;5;10;11737;18139;29876;5335
ancienne ;9;1063;13;38;51;9;9;18;13819;40394;54213;9567
genre ;6;1063;9;28;37;6;6;12;9567;29764;39331;6378
economique ;11;1061;19;56;75;11;11;22;20159;59416;79575;11671
romaine ;8;1061;14;29;43;8;8;16;14854;30769;45623;8488
aucun ;6;1060;11;21;32;6;6;12;11660;22260;33920;6360
forment ;8;1060;15;36;51;8;8;16;15900;38160;54060;8480
permettent ;11;1057;22;48;70;11;11;22;23254;50736;73990;11627
troupes ;8;1056;18;32;50;8;8;16;19008;33792;52800;8448
juste ;6;1056;13;18;31;6;6;12;13728;19008;32736;6336
zone ;5;1055;9;29;38;5;5;10;9495;30595;40090;5275
mise ;5;1055;9;15;24;5;5;10;9495;15825;25320;5275
printemps ;10;1051;21;41;62;10;10;20;22071;43091;65162;10510
vitesse ;8;1050;17;26;43;8;8;16;17850;27300;45150;8400
majorite ;9;1047;17;28;45;9;9;18;17799;29316;47115;9423
vue ;4;1047;8;16;24;4;4;8;8376;16752;25128;4188
desormais ;10;1043;19;32;51;10;10;20;19817;33376;53193;10430
six ;4;1042;9;11;20;4;4;8;9378;11462;20840;4168
elu ;4;1041;7;15;22;4;4;8;7287;15615;22902;4164
national ;9;1040;16;32;48;9;9;18;16640;33280;49920;9360
vraiment ;9;1038;18;30;48;9;9;18;18684;31140;49824;9342
pense ;6;1036;10;29;39;6;6;12;10360;30044;40404;6216
actuellement ;13;1035;23;54;77;13;13;26;23805;55890;79695;13455
difficile ;10;1033;14;37;51;10;10;20;14462;38221;52683;10330
climat ;7;1033;12;20;32;7;7;14;12396;20660;33056;7231
classe ;7;1033;12;21;33;7;7;14;12396;21693;34089;7231
feu ;4;1032;6;18;24;4;4;8;6192;18576;24768;4128
objet ;6;1030;10;22;32;6;6;12;10300;22660;32960;6180
idees ;6;1030;9;21;30;6;6;12;9270;21630;30900;6180
haute ;6;1029;10;25;35;6;6;12;10290;25725;36015;6174
lyon ;5;1029;10;26;36;5;5;10;10290;26754;37044;5145
pourrait ;9;1027;20;28;48;9;9;18;20540;28756;49296;9243
retrouve ;9;1026;20;34;54;9;9;18;20520;34884;55404;9234
coup ;5;1025;9;24;33;5;5;10;9225;24600;33825;5125
recherche ;10;1023;14;47;61;10;10;20;14322;48081;62403;10230
langues ;8;1020;14;33;47;8;8;16;14280;33660;47940;8160
toi ;4;1020;8;12;20;4;4;8;8160;12240;20400;4080
v ;2;1020;4;6;10;2;2;4;4080;6120;10200;2040
assemblee ;10;1019;16;37;53;10;10;20;16304;37703;54007;10190
mots ;5;1018;11;18;29;5;5;10;11198;18324;29522;5090
accord ;7;1015;10;24;34;7;7;14;10150;24360;34510;7105
eviter ;7;1015;14;23;37;7;7;14;14210;23345;37555;7105
aime ;5;1013;7;15;22;5;5;10;7091;15195;22286;5065
oiseaux ;8;1011;16;30;46;8;8;16;16176;30330;46506;8088
image ;6;1010;8;23;31;6;6;12;8080;23230;31310;6060
peux ;5;1010;10;26;36;5;5;10;10100;26260;36360;5050
finalement ;11;1007;18;47;65;11;11;22;18126;47329;65455;11077
devenu ;7;1005;12;33;45;7;7;14;12060;33165;45225;7035
planete ;8;1004;13;36;49;8;8;16;13052;36144;49196;8032
version ;8;1004;17;29;46;8;8;16;17068;29116;46184;8032
maladie ;8;1001;11;26;37;8;8;16;11011;26026;37037;8008
developpement ;14;999;24;76;100;14;14;28;23976;75924;99900;13986
carriere ;9;999;16;23;39;9;9;18;15984;22977;38961;8991
ocean ;6;998;8;26;34;6;6;12;7984;25948;33932;5988
courant ;8;997;16;28;44;8;8;16;15952;27916;43868;7976
lois ;5;996;10;15;25;5;5;10;9960;14940;24900;4980
terres ;7;996;15;20;35;7;7;14;14940;19920;34860;6972
tel ;4;995;7;14;21;4;4;8;6965;13930;20895;3980
livres ;7;993;15;20;35;7;7;14;14895;19860;34755;6951
gaz ;4;992;6;20;26;4;4;8;5952;19840;25792;3968
pratique ;9;991;18;35;53;9;9;18;17838;34685;52523;8919
scientifiques ;14;990;27;53;80;14;14;28;26730;52470;79200;13860
traite ;7;986;14;17;31;7;7;14;13804;16762;30566;6902
travaux ;8;985;18;25;43;8;8;16;17730;24625;42355;7880
sauf ;5;982;9;16;25;5;5;10;8838;15712;24550;4910
loin ;5;981;9;19;28;5;5;10;8829;18639;27468;4905
nature ;7;981;14;23;37;7;7;14;13734;22563;36297;6867
egypte ;7;977;12;40;52;7;7;14;11724;39080;50804;6839
epouse ;7;977;13;34;47;7;7;14;12701;33218;45919;6839
premieres ;10;973;19;37;56;10;10;20;18487;36001;54488;9730
moyenne ;8;972;14;45;59;8;8;16;13608;43740;57348;7776
combat ;7;970;11;25;36;7;7;14;10670;24250;34920;6790
sort ;5;962;12;14;26;5;5;10;11544;13468;25012;4810
paix ;5;960;9;19;28;5;5;10;8640;18240;26880;4800
fer ;4;960;6;15;21;4;4;8;5760;14400;20160;3840
sang ;5;958;8;19;27;5;5;10;7664;18202;25866;4790
aider ;6;957;9;16;25;6;6;12;8613;15312;23925;5742
cinema ;7;957;10;25;35;7;7;14;9570;23925;33495;6699
album ;6;957;10;19;29;6;6;12;9570;18183;27753;5742
maintenant ;11;956;20;41;61;11;11;22;19120;39196;58316;10516
furent ;7;955;14;28;42;7;7;14;13370;26740;40110;6685
militaires ;11;955;22;27;49;11;11;22;21010;25785;46795;10505
poissons ;9;954;20;36;56;9;9;18;19080;34344;53424;8586
connue ;7;952;12;34;46;7;7;14;11424;32368;43792;6664
liberte ;8;952;14;25;39;8;8;16;13328;23800;37128;7616
dix ;4;951;7;14;21;4;4;8;6657;13314;19971;3804
yeux ;5;951;11;26;37;5;5;10;10461;24726;35187;4755
francois ;9;950;16;31;47;9;9;18;15200;29450;44650;8550
considere ;10;947;17;39;56;10;10;20;16099;36933;53032;9470
quoi ;5;946;10;22;32;5;5;10;9460;20812;30272;4730
probleme ;9;946;15;41;56;9;9;18;14190;38786;52976;8514
style ;6;946;13;24;37;6;6;12;12298;22704;35002;5676
sorte ;6;946;13;20;33;6;6;12;12298;18920;31218;5676
etudes ;7;945;13;27;40;7;7;14;12285;25515;37800;6615
deputes ;8;945;15;35;50;8;8;16;14175;33075;47250;7560
victoire ;9;944;18;29;47;9;9;18;16992;27376;44368;8496
groupes ;8;943;16;37;53;8;8;16;15088;34891;49979;7544
ecrire ;7;941;12;20;32;7;7;14;11292;18820;30112;6587
cite ;5;941;8;15;23;5;5;10;7528;14115;21643;4705
organisation ;13;940;25;47;72;13;13;26;23500;44180;67680;12220
proteger ;9;940;17;41;58;9;9;18;15980;38540;54520;8460
cour ;5;937;10;17;27;5;5;10;9370;15929;25299;4685
uvres ;6;936;14;19;33;6;6;12;13104;17784;30888;5616
lequel ;7;935;12;34;46;7;7;14;11220;31790;43010;6545
liste ;6;934;12;17;29;6;6;12;11208;15878;27086;5604
aura ;5;933;9;10;19;5;5;10;8397;9330;17727;4665
scene ;6;931;9;25;34;6;6;12;8379;23275;31654;5586
harry ;6;930;12;22;34;6;6;12;11160;20460;31620;5580
prise ;6;930;12;19;31;6;6;12;11160;17670;28830;5580
personnages ;12;930;22;55;77;12;12;24;20460;51150;71610;11160
tandis ;7;926;13;20;33;7;7;14;12038;18520;30558;6482
plan ;5;925;8;21;29;5;5;10;7400;19425;26825;4625
pourtant ;9;925;20;35;55;9;9;18;18500;32375;50875;8325
f ;2;923;2;8;10;2;2;4;1846;7384;9230;1846
direction ;10;922;18;35;53;10;10;20;16596;32270;48866;9220
propre ;7;921;14;32;46;7;7;14;12894;29472;42366;6447
longue ;7;919;12;36;48;7;7;14;11028;33084;44112;6433
independance ;13;919;18;62;80;13;13;26;16542;56978;73520;11947
allemande ;10;918;14;41;55;10;10;20;12852;37638;50490;9180
represente ;11;916;21;46;67;11;11;22;19236;42136;61372;10076
principal ;10;916;18;36;54;10;10;20;16488;32976;49464;9160
chacun ;7;916;10;30;40;7;7;14;9160;27480;36640;6412
joue ;5;914;9;20;29;5;5;10;8226;18280;26506;4570
joueur ;7;913;15;25;40;7;7;14;13695;22825;36520;6391
passe ;6;912;11;21;32;6;6;12;10032;19152;29184;5472
temperature ;12;911;24;46;70;12;12;24;21864;41906;63770;10932
quelque ;8;911;15;43;58;8;8;16;13665;39173;52838;7288
sujet ;6;910;13;18;31;6;6;12;11830;16380;28210;5460
parties ;8;910;16;24;40;8;8;16;14560;21840;36400;7280
centrale ;9;910;15;33;48;9;9;18;13650;30030;43680;8190
ufs ;4;908;8;14;22;4;4;8;7264;12712;19976;3632
prince ;7;905;12;27;39;7;7;14;10860;24435;35295;6335
port ;5;904;11;20;31;5;5;10;9944;18080;28024;4520
utilisateur ;12;903;27;32;59;12;12;24;24381;28896;53277;10836
populaire ;10;898;19;42;61;10;10;20;17062;37716;54778;8980
voix ;5;898;11;21;32;5;5;10;9878;18858;28736;4490
autant ;7;897;14;21;35;7;7;14;12558;18837;31395;6279
etoile ;7;897;12;28;40;7;7;14;10764;25116;35880;6279
elections ;10;895;18;40;58;10;10;20;16110;35800;51910;8950
britannique ;12;894;23;43;66;12;12;24;20562;38442;59004;10728
presence ;9;894;15;40;55;9;9;18;13410;35760;49170;8046
journee ;8;892;15;33;48;8;8;16;13380;29436;42816;7136
anciens ;8;892;13;28;41;8;8;16;11596;24976;36572;7136
foret ;6;892;11;25;36;6;6;12;9812;22300;32112;5352
automne ;8;892;15;34;49;8;8;16;13380;30328;43708;7136
sept ;5;891;10;20;30;5;5;10;8910;17820;26730;4455
lune ;5;891;9;21;30;5;5;10;8019;18711;26730;4455
faisant ;8;890;14;24;38;8;8;16;12460;21360;33820;7120
route ;6;890;13;22;35;6;6;12;11570;19580;31150;5340
libre ;6;888;10;16;26;6;6;12;8880;14208;23088;5328
cree ;5;888;7;18;25;5;5;10;6216;15984;22200;4440
rend ;5;887;8;19;27;5;5;10;7096;16853;23949;4435
of ;3;886;4;15;19;3;3;6;3544;13290;16834;2658
siecles ;8;885;14;26;40;8;8;16;12390;23010;35400;7080
football ;9;884;15;38;53;9;9;18;13260;33592;46852;7956
morts ;6;884;14;19;33;6;6;12;12376;16796;29172;5304
couleurs ;9;883;19;33;52;9;9;18;16777;29139;45916;7947
jesus ;6;882;13;17;30;6;6;12;11466;14994;26460;5292
cuisine ;8;882;15;25;40;8;8;16;13230;22050;35280;7056
wikipedia ;10;881;17;34;51;10;10;20;14977;29954;44931;8810
travers ;8;880;18;21;39;8;8;16;15840;18480;34320;7040
meilleur ;9;879;17;32;49;9;9;18;14943;28128;43071;7911
londres ;8;878;15;32;47;8;8;16;13170;28096;41266;7024
antiquite ;10;878;20;36;56;10;10;20;17560;31608;49168;8780
second ;7;877;11;31;42;7;7;14;9647;27187;36834;6139
credit ;7;875;12;21;33;7;7;14;10500;18375;28875;6125
avis ;5;875;10;11;21;5;5;10;8750;9625;18375;4375
attaque ;8;874;15;30;45;8;8;16;13110;26220;39330;6992
vivant ;7;872;15;23;38;7;7;14;13080;20056;33136;6104
elements ;9;872;16;39;55;9;9;18;13952;34008;47960;7848
new ;4;871;7;19;26;4;4;8;6097;16549;22646;3484
amis ;5;871;9;11;20;5;5;10;7839;9581;17420;4355
europeens ;10;871;19;47;66;10;10;20;16549;40937;57486;8710
i ;2;870;3;2;5;2;2;4;2610;1740;4350;1740
roman ;6;870;11;22;33;6;6;12;9570;19140;28710;5220
informations ;13;869;26;49;75;13;13;26;22594;42581;65175;11297
dieux ;6;868;11;24;35;6;6;12;9548;20832;30380;5208
moitie ;7;867;13;24;37;7;7;14;11271;20808;32079;6069
arrivee ;8;867;15;23;38;8;8;16;13005;19941;32946;6936
depart ;7;865;12;26;38;7;7;14;10380;22490;32870;6055
jouer ;6;863;12;21;33;6;6;12;10356;18123;28479;5178
forte ;6;863;11;25;36;6;6;12;9493;21575;31068;5178
joueurs ;8;862;18;27;45;8;8;16;15516;23274;38790;6896
femelle ;8;861;11;39;50;8;8;16;9471;33579;43050;6888
fais ;5;856;8;13;21;5;5;10;6848;11128;17976;4280
sait ;5;856;10;9;19;5;5;10;8560;7704;16264;4280
peau ;5;855;8;21;29;5;5;10;6840;17955;24795;4275
bretagne ;9;854;14;36;50;9;9;18;11956;30744;42700;7686
problemes ;10;851;18;43;61;10;10;20;15318;36593;51911;8510
demi ;5;851;7;18;25;5;5;10;5957;15318;21275;4255
nee ;4;850;5;19;24;4;4;8;4250;16150;20400;3400
emission ;9;850;18;31;49;9;9;18;15300;26350;41650;7650
britanniques ;13;848;26;45;71;13;13;26;22048;38160;60208;11024
domaine ;8;847;12;33;45;8;8;16;10164;27951;38115;6776
insectes ;9;846;17;31;48;9;9;18;14382;26226;40608;7614
video ;6;845;10;25;35;6;6;12;8450;21125;29575;5070
americaine ;11;845;17;35;52;11;11;22;14365;29575;43940;9295
commun ;7;843;13;32;45;7;7;14;10959;26976;37935;5901
source ;7;843;14;25;39;7;7;14;11802;21075;32877;5901
auteur ;7;842;15;21;36;7;7;14;12630;17682;30312;5894
obtenir ;8;841;15;28;43;8;8;16;12615;23548;36163;6728
juifs ;6;839;12;17;29;6;6;12;10068;14263;24331;5034
contrairement ;14;837;27;52;79;14;14;28;22599;43524;66123;11718
seuls ;6;836;13;19;32;6;6;12;10868;15884;26752;5016
pieces ;7;835;11;28;39;7;7;14;9185;23380;32565;5845
finale ;7;835;10;27;37;7;7;14;8350;22545;30895;5845
heure ;6;833;10;27;37;6;6;12;8330;22491;30821;4998
siege ;6;833;9;24;33;6;6;12;7497;19992;27489;4998
modele ;7;830;10;34;44;7;7;14;8300;28220;36520;5810
nourriture ;11;829;26;35;61;11;11;22;21554;29015;50569;9119
pont ;5;829;10;25;35;5;5;10;8290;20725;29015;4145
longueur ;9;827;18;41;59;9;9;18;14886;33907;48793;7443
contient ;9;827;17;37;54;9;9;18;14059;30599;44658;7443
toutefois ;10;825;21;41;62;10;10;20;17325;33825;51150;8250
obtient ;8;821;15;30;45;8;8;16;12315;24630;36945;6568
utilisee ;9;820;18;28;46;9;9;18;14760;22960;37720;7380
pouvait ;8;820;17;31;48;8;8;16;13940;25420;39360;6560
ciel ;5;813;7;16;23;5;5;10;5691;13008;18699;4065
message ;8;813;13;32;45;8;8;16;10569;26016;36585;6504
physique ;9;812;18;48;66;9;9;18;14616;38976;53592;7308
arbres ;7;812;13;16;29;7;7;14;10556;12992;23548;5684
comprendre ;11;811;19;50;69;11;11;22;15409;40550;55959;8921
tels ;5;810;10;16;26;5;5;10;8100;12960;21060;4050
territoires ;12;810;27;33;60;12;12;24;21870;26730;48600;9720
fond ;5;810;7;26;33;5;5;10;5670;21060;26730;4050
recoit ;7;808;13;23;36;7;7;14;10504;18584;29088;5656
regles ;7;806;12;28;40;7;7;14;9672;22568;32240;5642
images ;7;806;11;25;36;7;7;14;8866;20150;29016;5642
altitude ;9;806;17;29;46;9;9;18;13702;23374;37076;7254
peuples ;8;806;15;39;54;8;8;16;12090;31434;43524;6448
election ;9;805;15;38;53;9;9;18;12075;30590;42665;7245
pattes ;7;805;14;25;39;7;7;14;11270;20125;31395;5635
concours ;9;803;18;36;54;9;9;18;14454;28908;43362;7227
puissance ;10;803;19;36;55;10;10;20;15257;28908;44165;8030
match ;6;802;9;24;33;6;6;12;7218;19248;26466;4812
particulierement ;17;802;33;62;95;17;17;34;26466;49724;76190;13634
filles ;7;802;12;25;37;7;7;14;9624;20050;29674;5614
voici ;6;800;11;19;30;6;6;12;8800;15200;24000;4800
familles ;9;800;15;32;47;9;9;18;12000;25600;37600;7200
bout ;5;800;10;18;28;5;5;10;8000;14400;22400;4000
communes ;9;800;17;40;57;9;9;18;13600;32000;45600;7200
jacques ;8;799;14;30;44;8;8;16;11186;23970;35156;6392
humains ;8;799;15;30;45;8;8;16;11985;23970;35955;6392
p ;2;797;3;9;12;2;2;4;2391;7173;9564;1594
aucune ;7;796;12;27;39;7;7;14;9552;21492;31044;5572
semaines ;9;794;16;31;47;9;9;18;12704;24614;37318;7146
franco ;7;794;11;28;39;7;7;14;8734;22232;30966;5558
avons ;6;793;12;23;35;6;6;12;9516;18239;27755;4758
temple ;7;793;12;33;45;7;7;14;9516;26169;35685;5551
derniers ;9;792;17;29;46;9;9;18;13464;22968;36432;7128
internet ;9;792;18;33;51;9;9;18;14256;26136;40392;7128
parc ;5;792;8;16;24;5;5;10;6336;12672;19008;3960
fete ;5;791;7;23;30;5;5;10;5537;18193;23730;3955
armes ;6;790;11;17;28;6;6;12;8690;13430;22120;4740
mode ;5;789;7;24;31;5;5;10;5523;18936;24459;3945
present ;8;788;16;33;49;8;8;16;12608;26004;38612;6304
occasion ;9;788;15;34;49;9;9;18;11820;26792;38612;7092
sport ;6;787;14;22;36;6;6;12;11018;17314;28332;4722
endroit ;8;787;15;30;45;8;8;16;11805;23610;35415;6296
rois ;5;787;11;12;23;5;5;10;8657;9444;18101;3935
mariage ;8;785;12;26;38;8;8;16;9420;20410;29830;6280
activite ;9;784;17;26;43;9;9;18;13328;20384;33712;7056
electrique ;11;784;20;45;65;11;11;22;15680;35280;50960;8624
activites ;10;783;20;28;48;10;10;20;15660;21924;37584;7830
chretiens ;10;783;18;39;57;10;10;20;14094;30537;44631;7830
manger ;7;780;11;29;40;7;7;14;8580;22620;31200;5460
quel ;5;779;9;24;33;5;5;10;7011;18696;25707;3895
discuter ;9;778;18;27;45;9;9;18;14004;21006;35010;7002
voire ;6;777;12;21;33;6;6;12;9324;16317;25641;4662
noire ;6;776;11;22;33;6;6;12;8536;17072;25608;4656
realite ;8;776;14;24;38;8;8;16;10864;18624;29488;6208
valeur ;7;775;14;23;37;7;7;14;10850;17825;28675;5425
eme ;4;775;5;18;23;4;4;8;3875;13950;17825;3100
province ;9;775;17;39;56;9;9;18;13175;30225;43400;6975
comprend ;9;775;15;43;58;9;9;18;11625;33325;44950;6975
directement ;12;774;21;47;68;12;12;24;16254;36378;52632;9288
ecoles ;7;772;11;30;41;7;7;14;8492;23160;31652;5404
americains ;11;771;19;31;50;11;11;22;14649;23901;38550;8481
urss ;5;770;13;10;23;5;5;10;10010;7700;17710;3850
creee ;6;770;8;24;32;6;6;12;6160;18480;24640;4620
reseau ;7;770;13;22;35;7;7;14;10010;16940;26950;5390
matiere ;8;769;14;25;39;8;8;16;10766;19225;29991;6152
religieux ;10;769;19;39;58;10;10;20;14611;29991;44602;7690
dynastie ;9;769;17;34;51;9;9;18;13073;26146;39219;6921
association ;12;767;23;38;61;12;12;24;17641;29146;46787;9204
types ;6;766;13;28;41;6;6;12;9958;21448;31406;4596
autoroute ;10;766;22;38;60;10;10;20;16852;29108;45960;7660
univers ;8;765;18;26;44;8;8;16;13770;19890;33660;6120
lire ;5;765;9;13;22;5;5;10;6885;9945;16830;3825
acces ;6;763;8;19;27;6;6;12;6104;14497;20601;4578
chaine ;7;763;9;29;38;7;7;14;6867;22127;28994;5341
chasse ;7;761;11;26;37;7;7;14;8371;19786;28157;5327
montagnes ;10;761;18;46;64;10;10;20;13698;35006;48704;7610
facilement ;11;760;17;45;62;11;11;22;12920;34200;47120;8360
kilometres ;11;760;22;39;61;11;11;22;16720;29640;46360;8360
minutes ;8;760;17;28;45;8;8;16;12920;21280;34200;6080
village ;8;758;13;31;44;8;8;16;9854;23498;33352;6064
questions ;10;757;22;41;63;10;10;20;16654;31037;47691;7570
ta ;3;756;5;6;11;3;3;6;3780;4536;8316;2268
programme ;10;756;18;44;62;10;10;20;13608;33264;46872;7560
feuilles ;9;755;16;35;51;9;9;18;12080;26425;38505;6795
etoiles ;8;754;15;30;45;8;8;16;11310;22620;33930;6032
passage ;8;753;13;31;44;8;8;16;9789;23343;33132;6024
chemin ;7;753;10;32;42;7;7;14;7530;24096;31626;5271
salle ;6;751;10;19;29;6;6;12;7510;14269;21779;4506
cathedrale ;11;749;16;43;59;11;11;22;11984;32207;44191;8239
entree ;7;748;12;29;41;7;7;14;8976;21692;30668;5236
mont ;5;748;10;22;32;5;5;10;7480;16456;23936;3740
code ;5;748;6;23;29;5;5;10;4488;17204;21692;3740
pression ;9;747;19;34;53;9;9;18;14193;25398;39591;6723
principaux ;11;747;22;43;65;11;11;22;16434;32121;48555;8217
masse ;6;746;11;18;29;6;6;12;8206;13428;21634;4476
raconte ;8;744;14;30;44;8;8;16;10416;22320;32736;5952
lieux ;6;744;12;23;35;6;6;12;8928;17112;26040;4464
designe ;8;742;12;35;47;8;8;16;8904;25970;34874;5936
sante ;6;742;11;20;31;6;6;12;8162;14840;23002;4452
large ;6;742;9;22;31;6;6;12;6678;16324;23002;4452
simplement ;11;741;21;47;68;11;11;22;15561;34827;50388;8151
blanche ;8;740;10;35;45;8;8;16;7400;25900;33300;5920
former ;7;740;13;28;41;7;7;14;9620;20720;30340;5180
fleuve ;7;740;12;33;45;7;7;14;8880;24420;33300;5180
wp ;3;740;6;15;21;3;3;6;4440;11100;15540;2220
grecs ;6;739;10;22;32;6;6;12;7390;16258;23648;4434
superficie ;11;738;20;41;61;11;11;22;14760;30258;45018;8118
york ;5;737;11;20;31;5;5;10;8107;14740;22847;3685
poste ;6;737;12;27;39;6;6;12;8844;19899;28743;4422
manque ;7;736;12;33;45;7;7;14;8832;24288;33120;5152
hauteur ;8;735;16;30;46;8;8;16;11760;22050;33810;5880
japonais ;9;735;16;31;47;9;9;18;11760;22785;34545;6615
fonctions ;10;734;19;44;63;10;10;20;13946;32296;46242;7340
humain ;7;734;12;28;40;7;7;14;8808;20552;29360;5138
inde ;5;734;7;19;26;5;5;10;5138;13946;19084;3670
moyens ;7;734;14;35;49;7;7;14;10276;25690;35966;5138
mesures ;8;734;17;27;44;8;8;16;12478;19818;32296;5872
garde ;6;734;8;23;31;6;6;12;5872;16882;22754;4404
suisse ;7;733;16;18;34;7;7;14;11728;13194;24922;5131
quartier ;9;732;19;28;47;9;9;18;13908;20496;34404;6588
importants ;11;732;24;39;63;11;11;22;17568;28548;46116;8052
commerce ;9;732;14;39;53;9;9;18;10248;28548;38796;6588
apparait ;9;732;16;28;44;9;9;18;11712;20496;32208;6588
lutte ;6;732;13;21;34;6;6;12;9516;15372;24888;4392
trouvent ;9;731;21;36;57;9;9;18;15351;26316;41667;6579
samedi ;7;731;11;22;33;7;7;14;8041;16082;24123;5117
importantes ;12;730;25;45;70;12;12;24;18250;32850;51100;8760
montre ;7;729;14;29;43;7;7;14;10206;21141;31347;5103
semble ;7;727;11;27;38;7;7;14;7997;19629;27626;5089
puisque ;8;727;17;35;52;8;8;16;12359;25445;37804;5816
construire ;11;727;24;36;60;11;11;22;17448;26172;43620;7997
entier ;7;726;13;24;37;7;7;14;9438;17424;26862;5082
belge ;6;726;7;28;35;6;6;12;5082;20328;25410;4356
voie ;5;724;9;20;29;5;5;10;6516;14480;20996;3620
atteint ;8;722;16;25;41;8;8;16;11552;18050;29602;5776
train ;6;722;12;14;26;6;6;12;8664;10108;18772;4332
chanson ;8;722;13;37;50;8;8;16;9386;26714;36100;5776
communaute ;11;722;21;47;68;11;11;22;15162;33934;49096;7942
xxe ;4;722;8;21;29;4;4;8;5776;15162;20938;2888
continue ;9;721;17;38;55;9;9;18;12257;27398;39655;6489
kg ;3;720;4;12;16;3;3;6;2880;8640;11520;2160
atteindre ;10;719;18;34;52;10;10;20;12942;24446;37388;7190
duree ;6;719;10;23;33;6;6;12;7190;16537;23727;4314
participe ;10;719;18;35;53;10;10;20;12942;25165;38107;7190
fruits ;7;719;16;19;35;7;7;14;11504;13661;25165;5033
avance ;7;716;10;26;36;7;7;14;7160;18616;25776;5012
proches ;8;716;14;38;52;8;8;16;10024;27208;37232;5728
voyage ;7;716;12;37;49;7;7;14;8592;26492;35084;5012
propose ;8;714;16;40;56;8;8;16;11424;28560;39984;5712
votre ;6;714;13;23;36;6;6;12;9282;16422;25704;4284
russes ;7;714;17;18;35;7;7;14;12138;12852;24990;4998
veulent ;8;713;16;35;51;8;8;16;11408;24955;36363;5704
course ;7;713;14;25;39;7;7;14;9982;17825;27807;4991
travailler ;11;713;22;30;52;11;11;22;15686;21390;37076;7843
connait ;8;712;14;30;44;8;8;16;9968;21360;31328;5696
lac ;4;712;5;11;16;4;4;8;3560;7832;11392;2848
position ;9;710;19;36;55;9;9;18;13490;25560;39050;6390
police ;7;710;11;31;42;7;7;14;7810;22010;29820;4970
marque ;7;709;13;28;41;7;7;14;9217;19852;29069;4963
du ;3;708;5;10;15;3;3;6;3540;7080;10620;2124
decision ;9;707;15;33;48;9;9;18;10605;23331;33936;6363
paysans ;8;707;16;31;47;8;8;16;11312;21917;33229;5656
partout ;8;706;18;29;47;8;8;16;12708;20474;33182;5648
belle ;6;706;8;24;32;6;6;12;5648;16944;22592;4236
montagne ;9;706;15;44;59;9;9;18;10590;31064;41654;6354
protection ;11;704;22;47;69;11;11;22;15488;33088;48576;7744
grece ;6;703;8;26;34;6;6;12;5624;18278;23902;4218
riche ;6;702;9;22;31;6;6;12;6318;15444;21762;4212
chat ;5;701;7;19;26;5;5;10;4907;13319;18226;3505
maitre ;7;701;13;19;32;7;7;14;9113;13319;22432;4907
actuelle ;9;701;15;34;49;9;9;18;10515;23834;34349;6309
composee ;9;700;15;46;61;9;9;18;10500;32200;42700;6300
iv ;3;698;6;7;13;3;3;6;4188;4886;9074;2094
laisse ;7;697;13;18;31;7;7;14;9061;12546;21607;4879
compagnie ;10;696;15;48;63;10;10;20;10440;33408;43848;6960
explique ;9;695;17;46;63;9;9;18;11815;31970;43785;6255
unique ;7;695;14;31;45;7;7;14;9730;21545;31275;4865
securite ;9;695;18;28;46;9;9;18;12510;19460;31970;6255
armees ;7;695;12;23;35;7;7;14;8340;15985;24325;4865
eaux ;5;694;9;20;29;5;5;10;6246;13880;20126;3470
poids ;6;693;11;24;35;6;6;12;7623;16632;24255;4158
appel ;6;693;9;29;38;6;6;12;6237;20097;26334;4158
lignes ;7;692;12;28;40;7;7;14;8304;19376;27680;4844
pied ;5;692;7;21;28;5;5;10;4844;14532;19376;3460
ait ;4;690;7;7;14;4;4;8;4830;4830;9660;2760
soient ;7;688;14;26;40;7;7;14;9632;17888;27520;4816
sur ;4;687;10;8;18;4;4;8;6870;5496;12366;2748
michel ;7;686;10;30;40;7;7;14;6860;20580;27440;4802
universite ;11;686;24;36;60;11;11;22;16464;24696;41160;7546
permettre ;10;685;20;40;60;10;10;20;13700;27400;41100;6850
facile ;7;685;9;25;34;7;7;14;6165;17125;23290;4795
bord ;5;685;8;17;25;5;5;10;5480;11645;17125;3425
membre ;7;685;11;27;38;7;7;14;7535;18495;26030;4795
heros ;6;685;11;26;37;6;6;12;7535;17810;25345;4110
grecque ;8;684;13;39;52;8;8;16;8892;26676;35568;5472
cheval ;7;683;10;31;41;7;7;14;6830;21173;28003;4781
paul ;5;683;9;19;28;5;5;10;6147;12977;19124;3415
tr ;3;682;7;5;12;3;3;6;4774;3410;8184;2046
dure ;5;681;9;17;26;5;5;10;6129;11577;17706;3405
g ;2;681;2;9;11;2;2;4;1362;6129;7491;1362
utilises ;9;680;20;24;44;9;9;18;13600;16320;29920;6120
parlement ;10;680;18;42;60;10;10;20;12240;28560;40800;6800
necessaire ;11;680;19;37;56;11;11;22;12920;25160;38080;7480
fleurs ;7;679;14;25;39;7;7;14;9506;16975;26481;4753
piece ;6;678;8;26;34;6;6;12;5424;17628;23052;4068
utilisateurs ;13;678;30;34;64;13;13;26;20340;23052;43392;8814
uniquement ;11;677;22;51;73;11;11;22;14894;34527;49421;7447
utilisation ;12;677;26;35;61;12;12;24;17602;23695;41297;8124
quantite ;9;677;18;35;53;9;9;18;12186;23695;35881;6093
decouvert ;10;676;19;42;61;10;10;20;12844;28392;41236;6760
decide ;7;676;8;28;36;7;7;14;5408;18928;24336;4732
crise ;6;675;11;15;26;6;6;12;7425;10125;17550;4050
chinois ;8;674;14;31;45;8;8;16;9436;20894;30330;5392
permis ;7;673;14;24;38;7;7;14;9422;16152;25574;4711
symbole ;8;673;15;36;51;8;8;16;10095;24228;34323;5384
peur ;5;669;10;20;30;5;5;10;6690;13380;20070;3345
attention ;10;668;20;38;58;10;10;20;13360;25384;38744;6680
royal ;6;666;12;23;35;6;6;12;7992;15318;23310;3996
noms ;5;666;10;21;31;5;5;10;6660;13986;20646;3330
principale ;11;665;19;42;61;11;11;22;12635;27930;40565;7315
influence ;10;665;16;45;61;10;10;20;10640;29925;40565;6650
risque ;7;664;15;24;39;7;7;14;9960;15936;25896;4648
pages ;6;663;9;27;36;6;6;12;5967;17901;23868;3978
interdit ;9;662;18;27;45;9;9;18;11916;17874;29790;5958
regarder ;9;661;15;31;46;9;9;18;9915;20491;30406;5949
entreprises ;12;660;25;43;68;12;12;24;16500;28380;44880;7920
constitution ;13;660;29;48;77;13;13;26;19140;31680;50820;8580
economie ;9;660;14;43;57;9;9;18;9240;28380;37620;5940
marins ;7;659;14;18;32;7;7;14;9226;11862;21088;4613
faible ;7;659;9;24;33;7;7;14;5931;15816;21747;4613
actuel ;7;658;12;24;36;7;7;14;7896;15792;23688;4606
compris ;8;657;16;29;45;8;8;16;10512;19053;29565;5256
journal ;8;657;16;27;43;8;8;16;10512;17739;28251;5256
justice ;8;657;16;23;39;8;8;16;10512;15111;25623;5256
formes ;7;656;13;29;42;7;7;14;8528;19024;27552;4592
jaune ;6;655;10;21;31;6;6;12;6550;13755;20305;3930
forces ;7;655;12;28;40;7;7;14;7860;18340;26200;4585
guerres ;8;654;16;29;45;8;8;16;10464;18966;29430;5232
commence ;9;654;13;44;57;9;9;18;8502;28776;37278;5886
artistes ;9;653;20;21;41;9;9;18;13060;13713;26773;5877
resistance ;11;653;21;34;55;11;11;22;13713;22202;35915;7183
occupe ;7;651;11;34;45;7;7;14;7161;22134;29295;4557
musulmans ;10;651;22;35;57;10;10;20;14322;22785;37107;6510
entreprise ;11;651;22;41;63;11;11;22;14322;26691;41013;7161
changer ;8;650;11;37;48;8;8;16;7150;24050;31200;5200
arbre ;6;650;10;14;24;6;6;12;6500;9100;15600;3900
formation ;10;650;19;40;59;10;10;20;12350;26000;38350;6500
bleu ;5;648;8;18;26;5;5;10;5184;11664;16848;3240
technique ;10;647;17;49;66;10;10;20;10999;31703;42702;6470
moderne ;8;645;13;37;50;8;8;16;8385;23865;32250;5160
froid ;6;644;10;22;32;6;6;12;6440;14168;20608;3864
sortie ;7;643;15;21;36;7;7;14;9645;13503;23148;4501
royale ;7;643;13;29;42;7;7;14;8359;18647;27006;4501
noirs ;6;643;13;18;31;6;6;12;8359;11574;19933;3858
tombe ;6;643;10;25;35;6;6;12;6430;16075;22505;3858
camp ;5;642;7;20;27;5;5;10;4494;12840;17334;3210
rh ;3;642;5;11;16;3;3;6;3210;7062;10272;1926
mains ;6;641;11;17;28;6;6;12;7051;10897;17948;3846
citoyens ;9;641;18;38;56;9;9;18;11538;24358;35896;5769
culte ;6;641;11;22;33;6;6;12;7051;14102;21153;3846
professeur ;11;641;23;45;68;11;11;22;14743;28845;43588;7051
devait ;7;641;12;23;35;7;7;14;7692;14743;22435;4487
xviiie ;7;641;14;22;36;7;7;14;8974;14102;23076;4487
internationale ;15;640;28;55;83;15;15;30;17920;35200;53120;9600
techniques ;11;638;20;51;71;11;11;22;12760;32538;45298;7018
situe ;6;637;13;17;30;6;6;12;8281;10829;19110;3822
hors ;5;637;10;20;30;5;5;10;6370;12740;19110;3185
pouvoirs ;9;636;21;36;57;9;9;18;13356;22896;36252;5724
plante ;7;636;12;30;42;7;7;14;7632;19080;26712;4452
historique ;11;634;23;44;67;11;11;22;14582;27896;42478;6974
milliers ;9;633;18;25;43;9;9;18;11394;15825;27219;5697
dispose ;8;633;15;32;47;8;8;16;9495;20256;29751;5064
tente ;6;633;11;25;36;6;6;12;6963;15825;22788;3798
resultat ;9;632;20;26;46;9;9;18;12640;16432;29072;5688
decouverte ;11;629;20;48;68;11;11;22;12580;30192;42772;6919
faisait ;8;628;14;19;33;8;8;16;8792;11932;20724;5024
affaires ;9;626;14;29;43;9;9;18;8764;18154;26918;5634
vent ;5;626;10;21;31;5;5;10;6260;13146;19406;3130
rester ;7;625;15;20;35;7;7;14;9375;12500;21875;4375
virus ;6;625;15;14;29;6;6;12;9375;8750;18125;3750
italien ;8;625;14;24;38;8;8;16;8750;15000;23750;5000
raisons ;8;624;17;22;39;8;8;16;10608;13728;24336;4992
freres ;7;623;13;24;37;7;7;14;8099;14952;23051;4361
chute ;6;623;10;27;37;6;6;12;6230;16821;23051;3738
derriere ;9;623;16;28;44;9;9;18;9968;17444;27412;5607
terrain ;8;622;16;21;37;8;8;16;9952;13062;23014;4976
dessous ;8;622;17;29;46;8;8;16;10574;18038;28612;4976
agriculture ;12;622;24;39;63;12;12;24;14928;24258;39186;7464
principe ;9;621;16;36;52;9;9;18;9936;22356;32292;5589
produire ;9;621;18;34;52;9;9;18;11178;21114;32292;5589
distance ;9;621;15;30;45;9;9;18;9315;18630;27945;5589
sovietique ;11;621;23;45;68;11;11;22;14283;27945;42228;6831
textes ;7;621;15;28;43;7;7;14;9315;17388;26703;4347
etres ;6;620;12;19;31;6;6;12;7440;11780;19220;3720
es ;3;619;5;9;14;3;3;6;3095;5571;8666;1857
honneur ;8;618;15;40;55;8;8;16;9270;24720;33990;4944
ligue ;6;618;10;24;34;6;6;12;6180;14832;21012;3708
chambre ;8;617;11;31;42;8;8;16;6787;19127;25914;4936
queue ;6;617;11;30;41;6;6;12;6787;18510;25297;3702
seine ;6;617;10;22;32;6;6;12;6170;13574;19744;3702
imp ;4;615;7;15;22;4;4;8;4305;9225;13530;2460
catholiques ;12;615;22;52;74;12;12;24;13530;31980;45510;7380
canada ;7;614;8;22;30;7;7;14;4912;13508;18420;4298
arabe ;6;613;8;15;23;6;6;12;4904;9195;14099;3678
marine ;7;613;12;22;34;7;7;14;7356;13486;20842;4291
atlantique ;11;613;21;41;62;11;11;22;12873;25133;38006;6743
espagnol ;9;612;15;44;59;9;9;18;9180;26928;36108;5508
aupres ;7;612;14;24;38;7;7;14;8568;14688;23256;4284
alpes ;6;611;10;23;33;6;6;12;6110;14053;20163;3666
eleve ;6;610;9;28;37;6;6;12;5490;17080;22570;3660
choix ;6;610;10;29;39;6;6;12;6100;17690;23790;3660
xiv ;4;610;9;14;23;4;4;8;5490;8540;14030;2440
francaises ;11;609;19;34;53;11;11;22;11571;20706;32277;6699
sorti ;6;609;14;15;29;6;6;12;8526;9135;17661;3654
riches ;7;609;12;24;36;7;7;14;7308;14616;21924;4263
theorie ;8;609;14;34;48;8;8;16;8526;20706;29232;4872
services ;9;608;18;28;46;9;9;18;10944;17024;27968;5472
charge ;7;608;9;31;40;7;7;14;5472;18848;24320;4256
decouvrir ;10;607;20;35;55;10;10;20;12140;21245;33385;6070
nouvel ;7;607;14;33;47;7;7;14;8498;20031;28529;4249
defense ;8;606;11;39;50;8;8;16;6666;23634;30300;4848
comporte ;9;605;17;42;59;9;9;18;10285;25410;35695;5445
huit ;5;605;10;18;28;5;5;10;6050;10890;16940;3025
bruxelles ;10;604;20;38;58;10;10;20;12080;22952;35032;6040
retrouver ;10;604;23;35;58;10;10;20;13892;21140;35032;6040
male ;5;604;7;18;25;5;5;10;4228;10872;15100;3020
laisser ;8;603;16;19;35;8;8;16;9648;11457;21105;4824
connus ;7;603;14;30;44;7;7;14;8442;18090;26532;4221
portugal ;9;603;18;38;56;9;9;18;10854;22914;33768;5427
rapide ;7;602;11;24;35;7;7;14;6622;14448;21070;4214
ecriture ;9;600;18;27;45;9;9;18;10800;16200;27000;5400
legende ;8;600;10;42;52;8;8;16;6000;25200;31200;4800
autrefois ;10;599;20;34;54;10;10;20;11980;20366;32346;5990
parvient ;9;598;18;33;51;9;9;18;10764;19734;30498;5382
potter ;7;598;15;29;44;7;7;14;8970;17342;26312;4186
arriere ;8;597;15;19;34;8;8;16;8955;11343;20298;4776
divers ;7;597;14;21;35;7;7;14;8358;12537;20895;4179
maisons ;8;596;16;26;42;8;8;16;9536;15496;25032;4768
adore ;6;593;9;22;31;6;6;12;5337;13046;18383;3558
presse ;7;592;14;26;40;7;7;14;8288;15392;23680;4144
riviere ;8;592;16;22;38;8;8;16;9472;13024;22496;4736
tuer ;5;592;11;15;26;5;5;10;6512;8880;15392;2960
tes ;4;591;8;12;20;4;4;8;4728;7092;11820;2364
transport ;10;591;23;34;57;10;10;20;13593;20094;33687;5910
sainte ;7;591;13;21;34;7;7;14;7683;12411;20094;4137
officielle ;11;589;16;48;64;11;11;22;9424;28272;37696;6479
contraire ;10;589;19;32;51;10;10;20;11191;18848;30039;5890
ami ;4;589;6;9;15;4;4;8;3534;5301;8835;2356
mediterranee ;13;588;22;49;71;13;13;26;12936;28812;41748;7644
importance ;11;588;20;44;64;11;11;22;11760;25872;37632;6468
international ;14;587;27;49;76;14;14;28;15849;28763;44612;8218
industrie ;10;587;21;30;51;10;10;20;12327;17610;29937;5870
nombres ;8;586;15;31;46;8;8;16;8790;18166;26956;4688
recu ;5;586;9;16;25;5;5;10;5274;9376;14650;2930
fortement ;10;586;19;45;64;10;10;20;11134;26370;37504;5860
connaitre ;10;585;18;37;55;10;10;20;10530;21645;32175;5850
certain ;8;585;14;24;38;8;8;16;8190;14040;22230;4680
existence ;10;585;18;42;60;10;10;20;10530;24570;35100;5850
enseignement ;13;585;22;62;84;13;13;26;12870;36270;49140;7605
al ;3;584;4;7;11;3;3;6;2336;4088;6424;1752
amour ;6;584;12;20;32;6;6;12;7008;11680;18688;3504
progressivement ;16;584;33;68;101;16;16;32;19272;39712;58984;9344
autorite ;9;584;19;28;47;9;9;18;11096;16352;27448;5256
ch ;3;584;3;14;17;3;3;6;1752;8176;9928;1752
ressemble ;10;584;18;36;54;10;10;20;10512;21024;31536;5840
defaite ;8;584;11;31;42;8;8;16;6424;18104;24528;4672
mission ;8;584;17;25;42;8;8;16;9928;14600;24528;4672
campagne ;9;584;12;42;54;9;9;18;7008;24528;31536;5256
oui ;4;583;8;13;21;4;4;8;4664;7579;12243;2332
statut ;7;581;17;18;35;7;7;14;9877;10458;20335;4067
administration ;15;580;30;46;76;15;15;30;17400;26680;44080;8700
partis ;7;577;15;18;33;7;7;14;8655;10386;19041;4039
cousin ;7;577;14;25;39;7;7;14;8078;14425;22503;4039
generale ;9;576;13;40;53;9;9;18;7488;23040;30528;5184
batiments ;10;576;19;32;51;10;10;20;10944;18432;29376;5760
mathematiques ;14;575;26;58;84;14;14;28;14950;33350;48300;8050
etats ;6;575;12;17;29;6;6;12;6900;9775;16675;3450
neanmoins ;10;575;18;42;60;10;10;20;10350;24150;34500;5750
correspond ;11;574;21;48;69;11;11;22;12054;27552;39606;6314
capable ;8;574;10;30;40;8;8;16;5740;17220;22960;4592
poisson ;8;574;17;34;51;8;8;16;9758;19516;29274;4592
vivants ;8;574;18;25;43;8;8;16;10332;14350;24682;4592
participer ;11;573;21;36;57;11;11;22;12033;20628;32661;6303
chaleur ;8;573;13;31;44;8;8;16;7449;17763;25212;4584
vallee ;7;573;11;28;39;7;7;14;6303;16044;22347;4011
donnees ;8;572;13;39;52;8;8;16;7436;22308;29744;4576
navires ;8;572;16;24;40;8;8;16;9152;13728;22880;4576
nourrit ;8;572;19;24;43;8;8;16;10868;13728;24596;4576
consiste ;9;571;18;32;50;9;9;18;10278;18272;28550;5139
cellules ;9;571;16;35;51;9;9;18;9136;19985;29121;5139
frontiere ;10;570;19;39;58;10;10;20;10830;22230;33060;5700
lettres ;8;569;17;26;43;8;8;16;9673;14794;24467;4552
doute ;6;569;11;26;37;6;6;12;6259;14794;21053;3414
orient ;7;568;14;25;39;7;7;14;7952;14200;22152;3976
radio ;6;568;10;17;27;6;6;12;5680;9656;15336;3408
carte ;6;568;10;17;27;6;6;12;5680;9656;15336;3408
mur ;4;567;9;11;20;4;4;8;5103;6237;11340;2268
categorie ;10;567;16;39;55;10;10;20;9072;22113;31185;5670
milliards ;10;567;19;26;45;10;10;20;10773;14742;25515;5670
zones ;6;567;12;31;43;6;6;12;6804;17577;24381;3402
forme ;6;566;10;27;37;6;6;12;5660;15282;20942;3396
provoque ;9;566;19;48;67;9;9;18;10754;27168;37922;5094
dimanche ;9;565;12;39;51;9;9;18;6780;22035;28815;5085
danger ;7;565;10;29;39;7;7;14;5650;16385;22035;3955
decouvre ;9;565;16;39;55;9;9;18;9040;22035;31075;5085
utilisent ;10;565;22;31;53;10;10;20;12430;17515;29945;5650
mouvements ;11;565;23;50;73;11;11;22;12995;28250;41245;6215
regulierement ;14;564;26;58;84;14;14;28;14664;32712;47376;7896
prison ;7;564;15;26;41;7;7;14;8460;14664;23124;3948
experience ;11;564;18;52;70;11;11;22;10152;29328;39480;6204
sortes ;7;564;16;22;38;7;7;14;9024;12408;21432;3948
allies ;7;564;12;20;32;7;7;14;6768;11280;18048;3948
viennent ;9;563;17;40;57;9;9;18;9571;22520;32091;5067
sais ;5;563;10;8;18;5;5;10;5630;4504;10134;2815
tours ;6;563;15;18;33;6;6;12;8445;10134;18579;3378
importe ;8;563;16;32;48;8;8;16;9008;18016;27024;4504
deviennent ;11;563;19;51;70;11;11;22;10697;28713;39410;6193
servir ;7;562;16;17;33;7;7;14;8992;9554;18546;3934
comte ;6;562;10;26;36;6;6;12;5620;14612;20232;3372
numero ;7;561;14;30;44;7;7;14;7854;16830;24684;3927
qualite ;8;560;15;30;45;8;8;16;8400;16800;25200;4480
australie ;10;560;20;26;46;10;10;20;11200;14560;25760;5600
viande ;7;558;11;26;37;7;7;14;6138;14508;20646;3906
science ;8;557;12;30;42;8;8;16;6684;16710;23394;4456
forets ;7;557;14;27;41;7;7;14;7798;15039;22837;3899
permettant ;11;557;22;44;66;11;11;22;12254;24508;36762;6127
principales ;12;557;22;44;66;12;12;24;12254;24508;36762;6684
nomme ;6;557;10;30;40;6;6;12;5570;16710;22280;3342
adultes ;8;556;15;27;42;8;8;16;8340;15012;23352;4448
bourgogne ;10;556;17;51;68;10;10;20;9452;28356;37808;5560
sexualite ;10;556;20;36;56;10;10;20;11120;20016;31136;5560
mario ;6;555;11;17;28;6;6;12;6105;9435;15540;3330
signe ;6;554;10;24;34;6;6;12;5540;13296;18836;3324
pologne ;8;554;13;47;60;8;8;16;7202;26038;33240;4432
relations ;10;554;20;33;53;10;10;20;11080;18282;29362;5540
metier ;7;554;13;23;36;7;7;14;7202;12742;19944;3878
victimes ;9;551;18;28;46;9;9;18;9918;15428;25346;4959
antique ;8;551;15;32;47;8;8;16;8265;17632;25897;4408
quelqu ;7;550;14;37;51;7;7;14;7700;20350;28050;3850
bande ;6;550;7;23;30;6;6;12;3850;12650;16500;3300
chien ;6;550;8;27;35;6;6;12;4400;14850;19250;3300
esclaves ;9;550;16;32;48;9;9;18;8800;17600;26400;4950
quitte ;7;550;15;27;42;7;7;14;8250;14850;23100;3850
peine ;6;549;9;28;37;6;6;12;4941;15372;20313;3294
fil ;4;549;6;13;19;4;4;8;3294;7137;10431;2196
ukraine ;8;549;15;24;39;8;8;16;8235;13176;21411;4392
anciennes ;10;549;16;40;56;10;10;20;8784;21960;30744;5490
apprendre ;10;548;17;44;61;10;10;20;9316;24112;33428;5480
suivante ;9;548;19;30;49;9;9;18;10412;16440;26852;4932
sciences ;9;548;15;32;47;9;9;18;8220;17536;25756;4932
chefs ;6;547;8;29;37;6;6;12;4376;15863;20239;3282
apparition ;11;547;21;40;61;11;11;22;11487;21880;33367;6017
fit ;4;547;7;12;19;4;4;8;3829;6564;10393;2188
joseph ;7;547;12;35;47;7;7;14;6564;19145;25709;3829
puisqu ;7;546;16;29;45;7;7;14;8736;15834;24570;3822
classique ;10;546;19;35;54;10;10;20;10374;19110;29484;5460
environnement ;14;545;27;65;92;14;14;28;14715;35425;50140;7630
rue ;4;545;8;12;20;4;4;8;4360;6540;10900;2180
extreme ;8;545;15;35;50;8;8;16;8175;19075;27250;4360
seigneur ;9;545;17;35;52;9;9;18;9265;19075;28340;4905
aime ;5;544;7;15;22;5;5;10;3808;8160;11968;2720
contenu ;8;544;15;37;52;8;8;16;8160;20128;28288;4352
suivant ;8;543;18;24;42;8;8;16;9774;13032;22806;4344
vol ;4;543;8;17;25;4;4;8;4344;9231;13575;2172
fondee ;7;543;9;38;47;7;7;14;4887;20634;25521;3801
communiste ;11;543;22;44;66;11;11;22;11946;23892;35838;5973
difference ;11;542;15;50;65;11;11;22;8130;27100;35230;5962
totalement ;11;542;21;46;67;11;11;22;11382;24932;36314;5962
demander ;9;541;13;37;50;9;9;18;7033;20017;27050;4869
sujets ;7;541;16;20;36;7;7;14;8656;10820;19476;3787
salut ;6;541;13;16;29;6;6;12;7033;8656;15689;3246
rouges ;7;540;14;29;43;7;7;14;7560;15660;23220;3780
provinces ;10;539;20;41;61;10;10;20;10780;22099;32879;5390
mondial ;8;538;13;31;44;8;8;16;6994;16678;23672;4304
naturel ;8;536;16;27;43;8;8;16;8576;14472;23048;4288
devenue ;8;536;13;39;52;8;8;16;6968;20904;27872;4288
bras ;5;536;9;9;18;5;5;10;4824;4824;9648;2680
xvie ;5;536;10;20;30;5;5;10;5360;10720;16080;2680
bresil ;7;536;13;18;31;7;7;14;6968;9648;16616;3752
etude ;6;535;10;25;35;6;6;12;5350;13375;18725;3210
maladies ;9;535;14;28;42;9;9;18;7490;14980;22470;4815
hitler ;7;535;13;25;38;7;7;14;6955;13375;20330;3745
beau ;5;534;7;16;23;5;5;10;3738;8544;12282;2670
celebres ;9;533;14;33;47;9;9;18;7462;17589;25051;4797
simon ;6;533;12;22;34;6;6;12;6396;11726;18122;3198
sommet ;7;532;14;29;43;7;7;14;7448;15428;22876;3724
alexandre ;10;532;16;40;56;10;10;20;8512;21280;29792;5320
langage ;8;531;10;37;47;8;8;16;5310;19647;24957;4248
realise ;8;531;14;23;37;8;8;16;7434;12213;19647;4248
senat ;6;531;11;20;31;6;6;12;5841;10620;16461;3186
bonaparte ;10;531;17;39;56;10;10;20;9027;20709;29736;5310
expression ;11;531;23;47;70;11;11;22;12213;24957;37170;5841
moteur ;7;530;15;27;42;7;7;14;7950;14310;22260;3710
pouvaient ;10;530;20;43;63;10;10;20;10600;22790;33390;5300
diverses ;9;529;18;29;47;9;9;18;9522;15341;24863;4761
difficultes ;12;529;21;45;66;12;12;24;11109;23805;34914;6348
canal ;6;529;8;19;27;6;6;12;4232;10051;14283;3174
equipes ;8;529;15;37;52;8;8;16;7935;19573;27508;4232
avions ;7;528;14;24;38;7;7;14;7392;12672;20064;3696
usage ;6;528;10;23;33;6;6;12;5280;12144;17424;3168
restent ;8;528;17;28;45;8;8;16;8976;14784;23760;4224
perd ;5;528;8;21;29;5;5;10;4224;11088;15312;2640
construite ;11;528;24;38;62;11;11;22;12672;20064;32736;5808
stade ;6;528;10;19;29;6;6;12;5280;10032;15312;3168
revient ;8;527;16;29;45;8;8;16;8432;15283;23715;4216
information ;12;527;23;47;70;12;12;24;12121;24769;36890;6324
k ;2;527;3;4;7;2;2;4;1581;2108;3689;1054
disparu ;8;526;16;24;40;8;8;16;8416;12624;21040;4208
objectif ;9;525;14;34;48;9;9;18;7350;17850;25200;4725
mammiferes ;11;525;19;41;60;11;11;22;9975;21525;31500;5775
combats ;8;525;14;27;41;8;8;16;7350;14175;21525;4200
quatrieme ;10;524;19;38;57;10;10;20;9956;19912;29868;5240
basse ;6;524;10;16;26;6;6;12;5240;8384;13624;3144
ouverture ;10;524;23;38;61;10;10;20;12052;19912;31964;5240
servent ;8;524;17;30;47;8;8;16;8908;15720;24628;4192
quelle ;7;523;12;34;46;7;7;14;6276;17782;24058;3661
lance ;6;523;8;23;31;6;6;12;4184;12029;16213;3138
veux ;5;523;11;23;34;5;5;10;5753;12029;17782;2615
litterature ;12;523;26;35;61;12;12;24;13598;18305;31903;6276
lille ;6;523;10;20;30;6;6;12;5230;10460;15690;3138
competition ;12;522;23;52;75;12;12;24;12006;27144;39150;6264
total ;6;522;12;20;32;6;6;12;6264;10440;16704;3132
suivre ;7;521;16;20;36;7;7;14;8336;10420;18756;3647
loup ;5;521;10;24;34;5;5;10;5210;12504;17714;2605
malheureusement ;16;520;30;70;100;16;16;32;15600;36400;52000;8320
rejoint ;8;520;16;27;43;8;8;16;8320;14040;22360;4160
lait ;5;520;9;11;20;5;5;10;4680;5720;10400;2600
outils ;7;520;16;22;38;7;7;14;8320;11440;19760;3640
marche ;7;520;10;28;38;7;7;14;5200;14560;19760;3640
donnent ;8;517;14;40;54;8;8;16;7238;20680;27918;4136
batiment ;9;516;16;30;46;9;9;18;8256;15480;23736;4644
lien ;5;516;8;18;26;5;5;10;4128;9288;13416;2580
voiture ;8;515;18;28;46;8;8;16;9270;14420;23690;4120
envie ;6;515;10;25;35;6;6;12;5150;12875;18025;3090
maire ;6;515;10;16;26;6;6;12;5150;8240;13390;3090
ecrivain ;9;514;16;27;43;9;9;18;8224;13878;22102;4626
olympiques ;11;514;23;55;78;11;11;22;11822;28270;40092;5654
refuse ;7;513;13;27;40;7;7;14;6669;13851;20520;3591
civile ;7;512;12;22;34;7;7;14;6144;11264;17408;3584
vert ;5;512;11;16;27;5;5;10;5632;8192;13824;2560
venir ;6;511;12;20;32;6;6;12;6132;10220;16352;3066
double ;7;511;11;30;41;7;7;14;5621;15330;20951;3577
faite ;6;510;9;20;29;6;6;12;4590;10200;14790;3060
in ;3;510;5;8;13;3;3;6;2550;4080;6630;1530
edition ;8;509;14;30;44;8;8;16;7126;15270;22396;4072
ts ;3;509;7;6;13;3;3;6;3563;3054;6617;1527
electricite ;12;509;21;40;61;12;12;24;10689;20360;31049;6108
john ;5;509;8;25;33;5;5;10;4072;12725;16797;2545
avion ;6;508;11;22;33;6;6;12;5588;11176;16764;3048
ailes ;6;508;10;16;26;6;6;12;5080;8128;13208;3048
possedent ;10;508;19;46;65;10;10;20;9652;23368;33020;5080
utc ;4;508;8;12;20;4;4;8;4064;6096;10160;2032
jeunesse ;9;507;17;35;52;9;9;18;8619;17745;26364;4563
cirque ;7;507;13;26;39;7;7;14;6591;13182;19773;3549
exterieur ;10;507;21;36;57;10;10;20;10647;18252;28899;5070
prennent ;9;507;17;43;60;9;9;18;8619;21801;30420;4563
oubliee ;8;507;13;32;45;8;8;16;6591;16224;22815;4056
change ;7;506;8;36;44;7;7;14;4048;18216;22264;3542
mythologie ;11;506;20;59;79;11;11;22;10120;29854;39974;5566
adulte ;7;506;12;25;37;7;7;14;6072;12650;18722;3542
actions ;8;505;15;26;41;8;8;16;7575;13130;20705;4040
sources ;8;505;17;27;44;8;8;16;8585;13635;22220;4040
solaire ;8;505;15;24;39;8;8;16;7575;12120;19695;4040
sein ;5;505;9;16;25;5;5;10;4545;8080;12625;2525
unite ;6;504;12;21;33;6;6;12;6048;10584;16632;3024
dessin ;7;504;13;23;36;7;7;14;6552;11592;18144;3528
francs ;7;504;12;23;35;7;7;14;6048;11592;17640;3528
champion ;9;504;14;43;57;9;9;18;7056;21672;28728;4536
communistes ;12;504;25;46;71;12;12;24;12600;23184;35784;6048
soir ;5;503;11;12;23;5;5;10;5533;6036;11569;2515
essentiellement ;16;502;30;67;97;16;16;32;15060;33634;48694;8032
athenes ;8;502;13;35;48;8;8;16;6526;17570;24096;4016
chaud ;6;501;8;25;33;6;6;12;4008;12525;16533;3006
officiellement ;15;501;24;68;92;15;15;30;12024;34068;46092;7515
cesar ;6;501;10;16;26;6;6;12;5010;8016;13026;3006
annonce ;8;500;12;38;50;8;8;16;6000;19000;25000;4000
gagner ;7;499;10;32;42;7;7;14;4990;15968;20958;3493
conflit ;8;499;14;33;47;8;8;16;6986;16467;23453;3992
protestants ;12;499;27;44;71;12;12;24;13473;21956;35429;5988
arc ;4;499;6;8;14;4;4;8;2994;3992;6986;1996
tiers ;6;499;13;14;27;6;6;12;6487;6986;13473;2994
europeen ;9;498;16;45;61;9;9;18;7968;22410;30378;4482
oiseau ;7;498;13;23;36;7;7;14;6474;11454;17928;3486
germanique ;11;498;19;49;68;11;11;22;9462;24402;33864;5478
central ;8;498;14;27;41;8;8;16;6972;13446;20418;3984
deroule ;8;497;14;34;48;8;8;16;6958;16898;23856;3976
court ;6;497;13;20;33;6;6;12;6461;9940;16401;2982
defendre ;9;497;12;43;55;9;9;18;5964;21371;27335;4473
matin ;6;496;11;18;29;6;6;12;5456;8928;14384;2976
veritable ;10;496;18;32;50;10;10;20;8928;15872;24800;4960
cadre ;6;496;8;19;27;6;6;12;3968;9424;13392;2976
monarchie ;10;496;16;42;58;10;10;20;7936;20832;28768;4960
pensent ;8;495;15;38;53;8;8;16;7425;18810;26235;3960
marche ;7;495;10;28;38;7;7;14;4950;13860;18810;3465
danse ;6;495;9;22;31;6;6;12;4455;10890;15345;2970
originaire ;11;495;20;35;55;11;11;22;9900;17325;27225;5445
biens ;6;495;10;19;29;6;6;12;4950;9405;14355;2970
voter ;6;495;13;23;36;6;6;12;6435;11385;17820;2970
sucre ;6;495;12;18;30;6;6;12;5940;8910;14850;2970
pourra ;7;494;15;24;39;7;7;14;7410;11856;19266;3458
opposition ;11;494;23;51;74;11;11;22;11362;25194;36556;5434
neuf ;5;494;8;24;32;5;5;10;3952;11856;15808;2470
operation ;10;494;19;42;61;10;10;20;9386;20748;30134;4940
dangereux ;10;493;17;46;63;10;10;20;8381;22678;31059;4930
division ;9;492;18;29;47;9;9;18;8856;14268;23124;4428
belges ;7;492;10;30;40;7;7;14;4920;14760;19680;3444
futur ;6;492;14;20;34;6;6;12;6888;9840;16728;2952
machine ;8;492;11;34;45;8;8;16;5412;16728;22140;3936
porter ;7;491;15;27;42;7;7;14;7365;13257;20622;3437
meilleure ;10;491;18;38;56;10;10;20;8838;18658;27496;4910
publie ;7;490;12;27;39;7;7;14;5880;13230;19110;3430
choisi ;7;490;12;25;37;7;7;14;5880;12250;18130;3430
autorites ;10;490;22;30;52;10;10;20;10780;14700;25480;4900
decisions ;10;489;18;35;53;10;10;20;8802;17115;25917;4890
rares ;6;488;12;13;25;6;6;12;5856;6344;12200;2928
architecture ;13;488;24;45;69;13;13;26;11712;21960;33672;6344
contact ;8;487;14;30;44;8;8;16;6818;14610;21428;3896
front ;6;486;12;25;37;6;6;12;5832;12150;17982;2916
ordinateur ;11;485;22;37;59;11;11;22;10670;17945;28615;5335
encyclopedie ;13;485;20;66;86;13;13;26;9700;32010;41710;6305
probablement ;13;484;22;55;77;13;13;26;10648;26620;37268;6292
television ;11;484;22;42;64;11;11;22;10648;20328;30976;5324
ceci ;5;484;6;16;22;5;5;10;2904;7744;10648;2420
liquide ;8;484;14;31;45;8;8;16;6776;15004;21780;3872
convention ;11;484;21;52;73;11;11;22;10164;25168;35332;5324
continent ;10;484;19;43;62;10;10;20;9196;20812;30008;4840
sortir ;7;483;17;16;33;7;7;14;8211;7728;15939;3381
departements ;13;483;24;54;78;13;13;26;11592;26082;37674;6279
wiki ;5;483;10;12;22;5;5;10;4830;5796;10626;2415
entierement ;12;481;22;50;72;12;12;24;10582;24050;34632;5772
os ;3;481;6;10;16;3;3;6;2886;4810;7696;1443
esprit ;7;480;15;22;37;7;7;14;7200;10560;17760;3360
melange ;8;480;11;38;49;8;8;16;5280;18240;23520;3840
eut ;4;480;8;14;22;4;4;8;3840;6720;10560;1920
tradition ;10;479;20;30;50;10;10;20;9580;14370;23950;4790
occidentale ;12;479;18;49;67;12;12;24;8622;23471;32093;5748
males ;6;479;10;20;30;6;6;12;4790;9580;14370;2874
mexique ;8;479;15;39;54;8;8;16;7185;18681;25866;3832
bateau ;7;478;11;21;32;7;7;14;5258;10038;15296;3346
guillaume ;10;478;18;39;57;10;10;20;8604;18642;27246;4780
travaille ;10;478;19;29;48;10;10;20;9082;13862;22944;4780
sable ;6;478;9;18;27;6;6;12;4302;8604;12906;2868
phenomene ;10;477;15;60;75;10;10;20;7155;28620;35775;4770
faits ;6;477;11;16;27;6;6;12;5247;7632;12879;2862
perdu ;6;477;11;25;36;6;6;12;5247;11925;17172;2862
puisse ;7;477;15;24;39;7;7;14;7155;11448;18603;3339
trouve ;7;476;16;27;43;7;7;14;7616;12852;20468;3332
pacifique ;10;476;16;43;59;10;10;20;7616;20468;28084;4760
gris ;5;476;10;13;23;5;5;10;4760;6188;10948;2380
partisans ;10;476;21;28;49;10;10;20;9996;13328;23324;4760
eleve ;6;475;9;28;37;6;6;12;4275;13300;17575;2850
euros ;6;475;13;21;34;6;6;12;6175;9975;16150;2850
longues ;8;475;15;38;53;8;8;16;7125;18050;25175;3800
loire ;6;475;11;20;31;6;6;12;5225;9500;14725;2850
colonies ;9;475;16;38;54;9;9;18;7600;18050;25650;4275
champs ;7;474;11;31;42;7;7;14;5214;14694;19908;3318
modifier ;9;473;15;34;49;9;9;18;7095;16082;23177;4257
pain ;5;473;8;18;26;5;5;10;3784;8514;12298;2365
vieux ;6;473;13;24;37;6;6;12;6149;11352;17501;2838
indique ;8;472;14;33;47;8;8;16;6608;15576;22184;3776
souhaite ;9;472;17;35;52;9;9;18;8024;16520;24544;4248
massif ;7;472;13;20;33;7;7;14;6136;9440;15576;3304
renaissance ;12;472;21;39;60;12;12;24;9912;18408;28320;5664
xviie ;6;472;12;21;33;6;6;12;5664;9912;15576;2832
clerge ;7;472;10;30;40;7;7;14;4720;14160;18880;3304
populations ;12;472;25;53;78;12;12;24;11800;25016;36816;5664
pouvez ;7;472;15;40;55;7;7;14;7080;18880;25960;3304
ecologie ;9;471;13;44;57;9;9;18;6123;20724;26847;4239
rare ;5;471;9;11;20;5;5;10;4239;5181;9420;2355
mi ;3;471;5;7;12;3;3;6;2355;3297;5652;1413
elus ;5;471;10;17;27;5;5;10;4710;8007;12717;2355
eglises ;8;471;14;30;44;8;8;16;6594;14130;20724;3768
fonctionnement ;15;471;27;74;101;15;15;30;12717;34854;47571;7065
vi ;3;470;6;7;13;3;3;6;2820;3290;6110;1410
remporte ;9;469;18;38;56;9;9;18;8442;17822;26264;4221
monnaie ;8;468;13;34;47;8;8;16;6084;15912;21996;3744
rejoindre ;10;468;18;36;54;10;10;20;8424;16848;25272;4680
oppose ;7;468;13;39;52;7;7;14;6084;18252;24336;3276
quant ;6;468;12;25;37;6;6;12;5616;11700;17316;2808
joue ;5;466;9;20;29;5;5;10;4194;9320;13514;2330
installer ;10;466;20;30;50;10;10;20;9320;13980;23300;4660
temoigne ;9;466;15;43;58;9;9;18;6990;20038;27028;4194
pauvres ;8;466;17;29;46;8;8;16;7922;13514;21436;3728
candidat ;9;466;13;29;42;9;9;18;6058;13514;19572;4194
entrer ;7;465;14;24;38;7;7;14;6510;11160;17670;3255
constantinople ;15;465;29;66;95;15;15;30;13485;30690;44175;6975
assurer ;8;465;18;19;37;8;8;16;8370;8835;17205;3720
deesse ;7;465;11;28;39;7;7;14;5115;13020;18135;3255
nourrir ;8;464;19;22;41;8;8;16;8816;10208;19024;3712
interet ;8;464;16;27;43;8;8;16;7424;12528;19952;3712
nicolas ;8;463;14;27;41;8;8;16;6482;12501;18983;3704
aventures ;10;462;21;36;57;10;10;20;9702;16632;26334;4620
apparaissent ;13;462;25;44;69;13;13;26;11550;20328;31878;6006
uf ;3;462;5;12;17;3;3;6;2310;5544;7854;1386
noblesse ;9;462;16;37;53;9;9;18;7392;17094;24486;4158
terrestre ;10;462;22;30;52;10;10;20;10164;13860;24024;4620
papier ;7;461;12;27;39;7;7;14;5532;12447;17979;3227
auguste ;8;461;16;30;46;8;8;16;7376;13830;21206;3688
algerie ;8;461;12;29;41;8;8;16;5532;13369;18901;3688
eteint ;7;461;13;26;39;7;7;14;5993;11986;17979;3227
religieuse ;11;460;20;40;60;11;11;22;9200;18400;27600;5060
constitue ;10;460;21;37;58;10;10;20;9660;17020;26680;4600
remporte ;9;460;18;38;56;9;9;18;8280;17480;25760;4140
calendrier ;11;459;18;37;55;11;11;22;8262;16983;25245;5049
realiser ;9;459;17;24;41;9;9;18;7803;11016;18819;4131
sites ;6;459;13;15;28;6;6;12;5967;6885;12852;2754
tableau ;8;459;13;25;38;8;8;16;5967;11475;17442;3672
blancs ;7;459;11;22;33;7;7;14;5049;10098;15147;3213
tient ;6;458;12;20;32;6;6;12;5496;9160;14656;2748
espagnols ;10;458;18;46;64;10;10;20;8244;21068;29312;4580
termine ;8;458;15;29;44;8;8;16;6870;13282;20152;3664
developper ;11;457;19;57;76;11;11;22;8683;26049;34732;5027
lutter ;7;457;16;22;38;7;7;14;7312;10054;17366;3199
etend ;6;457;9;27;36;6;6;12;4113;12339;16452;2742
dos ;4;455;7;15;22;4;4;8;3185;6825;10010;1820
installe ;9;455;17;29;46;9;9;18;7735;13195;20930;4095
mange ;6;455;8;28;36;6;6;12;3640;12740;16380;2730
couple ;7;455;12;34;46;7;7;14;5460;15470;20930;3185
somme ;6;453;11;26;37;6;6;12;4983;11778;16761;2718
ministres ;10;453;22;28;50;10;10;20;9966;12684;22650;4530
alliance ;9;453;13;30;43;9;9;18;5889;13590;19479;4077
reportage ;10;452;18;43;61;10;10;20;8136;19436;27572;4520
fr ;3;452;5;9;14;3;3;6;2260;4068;6328;1356
jules ;6;452;12;19;31;6;6;12;5424;8588;14012;2712
continuer ;10;451;20;39;59;10;10;20;9020;17589;26609;4510
montrer ;8;450;17;30;47;8;8;16;7650;13500;21150;3600
thomas ;7;450;13;29;42;7;7;14;5850;13050;18900;3150
robert ;7;450;14;22;36;7;7;14;6300;9900;16200;3150
evolution ;10;450;21;44;65;10;10;20;9450;19800;29250;4500
administrateur ;15;450;31;43;74;15;15;30;13950;19350;33300;6750
tonnes ;7;449;14;31;45;7;7;14;6286;13919;20205;3143
maximum ;8;448;16;30;46;8;8;16;7168;13440;20608;3584
fonde ;6;448;8;32;40;6;6;12;3584;14336;17920;2688
croix ;6;448;12;21;33;6;6;12;5376;9408;14784;2688
publique ;9;447;17;40;57;9;9;18;7599;17880;25479;4023
vienne ;7;447;12;31;43;7;7;14;5364;13857;19221;3129
via ;4;446;7;9;16;4;4;8;3122;4014;7136;1784
different ;10;446;16;43;59;10;10;20;7136;19178;26314;4460
pieds ;6;445;10;23;33;6;6;12;4450;10235;14685;2670
recherches ;11;445;17;49;66;11;11;22;7565;21805;29370;4895
neige ;6;444;8;28;36;6;6;12;3552;12432;15984;2664
developpe ;10;444;16;56;72;10;10;20;7104;24864;31968;4440
arts ;5;444;11;9;20;5;5;10;4884;3996;8880;2220
detruit ;8;442;17;24;41;8;8;16;7514;10608;18122;3536
officiel ;9;442;13;38;51;9;9;18;5746;16796;22542;3978
prusse ;7;442;16;24;40;7;7;14;7072;10608;17680;3094
exposition ;11;441;23;49;72;11;11;22;10143;21609;31752;4851
proximite ;10;441;21;40;61;10;10;20;9261;17640;26901;4410
remplace ;9;441;14;37;51;9;9;18;6174;16317;22491;3969
jardin ;7;441;12;18;30;7;7;14;5292;7938;13230;3087
anti ;5;440;9;13;22;5;5;10;3960;5720;9680;2200
vingt ;6;440;12;24;36;6;6;12;5280;10560;15840;2640
noel ;5;440;8;24;32;5;5;10;3520;10560;14080;2200
reprend ;8;440;14;34;48;8;8;16;6160;14960;21120;3520
atmosphere ;11;439;20;50;70;11;11;22;8780;21950;30730;4829
utilisees ;10;439;21;30;51;10;10;20;9219;13170;22389;4390
metal ;6;439;10;21;31;6;6;12;4390;9219;13609;2634
vaste ;6;439;12;19;31;6;6;12;5268;8341;13609;2634
david ;6;438;9;19;28;6;6;12;3942;8322;12264;2628
representant ;13;438;26;51;77;13;13;26;11388;22338;33726;5694
acheter ;8;438;12;32;44;8;8;16;5256;14016;19272;3504
presents ;9;438;19;35;54;9;9;18;8322;15330;23652;3942
urs ;4;438;10;8;18;4;4;8;4380;3504;7884;1752
partage ;8;438;13;31;44;8;8;16;5694;13578;19272;3504
appartient ;11;438;21;41;62;11;11;22;9198;17958;27156;4818
domaines ;9;438;15;35;50;9;9;18;6570;15330;21900;3942
section ;8;438;15;30;45;8;8;16;6570;13140;19710;3504
existent ;9;437;19;35;54;9;9;18;8303;15295;23598;3933
personnel ;10;437;19;47;66;10;10;20;8303;20539;28842;4370
envoie ;7;437;12;32;44;7;7;14;5244;13984;19228;3059
vacances ;9;437;14;32;46;9;9;18;6118;13984;20102;3933
dents ;6;437;11;23;34;6;6;12;4807;10051;14858;2622
consideree ;11;437;18;45;63;11;11;22;7866;19665;27531;4807
femelles ;9;437;14;41;55;9;9;18;6118;17917;24035;3933
reporters ;10;436;22;36;58;10;10;20;9592;15696;25288;4360
arreter ;8;436;16;21;37;8;8;16;6976;9156;16132;3488
religieuses ;12;436;23;42;65;12;12;24;10028;18312;28340;5232
and ;4;436;5;14;19;4;4;8;2180;6104;8284;1744
bateaux ;8;435;14;28;42;8;8;16;6090;12180;18270;3480
signe ;6;434;10;24;34;6;6;12;4340;10416;14756;2604
reussi ;7;434;16;17;33;7;7;14;6944;7378;14322;3038
ennemis ;8;434;14;33;47;8;8;16;6076;14322;20398;3472
gare ;5;434;7;18;25;5;5;10;3038;7812;10850;2170
championnat ;12;434;20;54;74;12;12;24;8680;23436;32116;5208
dernieres ;10;433;18;35;53;10;10;20;7794;15155;22949;4330
auteurs ;8;433;18;23;41;8;8;16;7794;9959;17753;3464
islam ;6;433;11;15;26;6;6;12;4763;6495;11258;2598
pose ;5;433;9;24;33;5;5;10;3897;10392;14289;2165
reponse ;8;433;15;37;52;8;8;16;6495;16021;22516;3464
apprend ;8;432;13;37;50;8;8;16;5616;15984;21600;3456
seraient ;9;432;17;28;45;9;9;18;7344;12096;19440;3888
coulisses ;10;432;21;33;54;10;10;20;9072;14256;23328;4320
suit ;5;431;12;11;23;5;5;10;5172;4741;9913;2155
romans ;7;431;14;24;38;7;7;14;6034;10344;16378;3017
pierres ;8;431;16;26;42;8;8;16;6896;11206;18102;3448
fabrication ;12;431;20;38;58;12;12;24;8620;16378;24998;5172
repondre ;9;431;16;41;57;9;9;18;6896;17671;24567;3879
humaine ;8;431;13;34;47;8;8;16;5603;14654;20257;3448
chance ;7;430;8;32;40;7;7;14;3440;13760;17200;3010
chansons ;9;430;16;39;55;9;9;18;6880;16770;23650;3870
nintendo ;9;430;16;41;57;9;9;18;6880;17630;24510;3870
ouvert ;7;430;16;27;43;7;7;14;6880;11610;18490;3010
cher ;5;430;7;21;28;5;5;10;3010;9030;12040;2150
centaines ;10;429;17;37;54;10;10;20;7293;15873;23166;4290
lettre ;7;429;14;24;38;7;7;14;6006;10296;16302;3003
developpe ;10;429;16;56;72;10;10;20;6864;24024;30888;4290
tue ;4;429;8;14;22;4;4;8;3432;6006;9438;1716
liens ;6;429;11;20;31;6;6;12;4719;8580;13299;2574
organise ;9;429;16;34;50;9;9;18;6864;14586;21450;3861
appelees ;9;428;14;43;57;9;9;18;5992;18404;24396;3852
murs ;5;428;12;13;25;5;5;10;5136;5564;10700;2140
pouvant ;8;428;17;36;53;8;8;16;7276;15408;22684;3424
portugais ;10;428;21;37;58;10;10;20;8988;15836;24824;4280
mauvais ;8;427;16;22;38;8;8;16;6832;9394;16226;3416
ameliorer ;10;427;18;34;52;10;10;20;7686;14518;22204;4270
classes ;8;426;15;23;38;8;8;16;6390;9798;16188;3408
halloween ;10;426;16;51;67;10;10;20;6816;21726;28542;4260
outre ;6;426;13;22;35;6;6;12;5538;9372;14910;2556
victime ;8;426;15;26;41;8;8;16;6390;11076;17466;3408
mda ;4;426;5;13;18;4;4;8;2130;5538;7668;1704
nobles ;7;425;12;29;41;7;7;14;5100;12325;17425;2975
zeus ;5;425;11;22;33;5;5;10;4675;9350;14025;2125
dinosaures ;11;425;22;37;59;11;11;22;9350;15725;25075;4675
ere ;4;424;6;14;20;4;4;8;2544;5936;8480;1696
presidentielle ;15;424;27;60;87;15;15;30;11448;25440;36888;6360
naturelle ;10;424;19;37;56;10;10;20;8056;15688;23744;4240
chevaux ;8;424;14;38;52;8;8;16;5936;16112;22048;3392
dehors ;7;423;12;31;43;7;7;14;5076;13113;18189;2961
gagne ;6;423;7;31;38;6;6;12;2961;13113;16074;2538
grave ;6;423;10;23;33;6;6;12;4230;9729;13959;2538
succede ;8;422;12;32;44;8;8;16;5064;13504;18568;3376
fabriquer ;10;422;18;35;53;10;10;20;7596;14770;22366;4220
propres ;8;421;17;34;51;8;8;16;7157;14314;21471;3368
resultats ;10;421;23;28;51;10;10;20;9683;11788;21471;4210
videos ;7;421;13;27;40;7;7;14;5473;11367;16840;2947
enfance ;8;421;10;38;48;8;8;16;4210;15998;20208;3368
payer ;6;421;11;26;37;6;6;12;4631;10946;15577;2526
conquete ;9;421;16;46;62;9;9;18;6736;19366;26102;3789
responsable ;12;420;22;48;70;12;12;24;9240;20160;29400;5040
huile ;6;420;10;25;35;6;6;12;4200;10500;14700;2520
cerveau ;8;420;14;29;43;8;8;16;5880;12180;18060;3360
finit ;6;420;11;19;30;6;6;12;4620;7980;12600;2520
frontieres ;11;419;22;41;63;11;11;22;9218;17179;26397;4609
volonte ;8;419;16;39;55;8;8;16;6704;16341;23045;3352
socialiste ;11;419;21;33;54;11;11;22;8799;13827;22626;4609
record ;7;418;12;25;37;7;7;14;5016;10450;15466;2926
plat ;5;418;9;18;27;5;5;10;3762;7524;11286;2090
etrangers ;10;417;19;36;55;10;10;20;7923;15012;22935;4170
lesquels ;9;417;18;38;56;9;9;18;7506;15846;23352;3753
extremement ;12;417;23;55;78;12;12;24;9591;22935;32526;5004
ouvriers ;9;417;21;28;49;9;9;18;8757;11676;20433;3753
envoyer ;8;417;16;40;56;8;8;16;6672;16680;23352;3336
concernant ;11;416;19;46;65;11;11;22;7904;19136;27040;4576
normandie ;10;416;17;40;57;10;10;20;7072;16640;23712;4160
aspect ;7;416;12;26;38;7;7;14;4992;10816;15808;2912
soutien ;8;416;17;30;47;8;8;16;7072;12480;19552;3328
designer ;9;416;15;36;51;9;9;18;6240;14976;21216;3744
anne ;5;416;7;21;28;5;5;10;2912;8736;11648;2080
methode ;8;416;12;42;54;8;8;16;4992;17472;22464;3328
navire ;7;416;13;22;35;7;7;14;5408;9152;14560;2912
iranienne ;10;416;17;36;53;10;10;20;7072;14976;22048;4160
consommation ;13;415;25;56;81;13;13;26;10375;23240;33615;5395
forcement ;10;415;17;46;63;10;10;20;7055;19090;26145;4150
turquie ;8;415;18;29;47;8;8;16;7470;12035;19505;3320
peinture ;9;415;18;36;54;9;9;18;7470;14940;22410;3735
publie ;7;415;12;27;39;7;7;14;4980;11205;16185;2905
chevaliers ;11;415;19;41;60;11;11;22;7885;17015;24900;4565
individus ;10;415;20;31;51;10;10;20;8300;12865;21165;4150
meilleurs ;10;414;20;34;54;10;10;20;8280;14076;22356;4140
episode ;8;414;13;36;49;8;8;16;5382;14904;20286;3312
revanche ;9;414;14;40;54;9;9;18;5796;16560;22356;3726
charge ;7;414;9;31;40;7;7;14;3726;12834;16560;2898
marin ;6;414;11;16;27;6;6;12;4554;6624;11178;2484
iraniennes ;11;414;20;38;58;11;11;22;8280;15732;24012;4554
obligatoire ;12;413;21;44;65;12;12;24;8673;18172;26845;4956
star ;5;413;11;9;20;5;5;10;4543;3717;8260;2065
mettent ;8;413;16;33;49;8;8;16;6608;13629;20237;3304
vis ;4;413;9;9;18;4;4;8;3717;3717;7434;1652
faites ;7;412;12;22;34;7;7;14;4944;9064;14008;2884
race ;5;412;7;14;21;5;5;10;2884;5768;8652;2060
ajouter ;8;412;16;26;42;8;8;16;6592;10712;17304;3296
mari ;5;412;9;10;19;5;5;10;3708;4120;7828;2060
immense ;8;411;14;32;46;8;8;16;5754;13152;18906;3288
couronne ;9;411;17;42;59;9;9;18;6987;17262;24249;3699
application ;12;411;21;47;68;12;12;24;8631;19317;27948;4932
vapeur ;7;411;14;27;41;7;7;14;5754;11097;16851;2877
sociale ;8;411;13;27;40;8;8;16;5343;11097;16440;3288
choisir ;8;410;15;26;41;8;8;16;6150;10660;16810;3280
obtenu ;7;410;13;30;43;7;7;14;5330;12300;17630;2870
proies ;7;409;14;26;40;7;7;14;5726;10634;16360;2863
enorme ;7;409;12;32;44;7;7;14;4908;13088;17996;2863
planetes ;9;409;16;38;54;9;9;18;6544;15542;22086;3681
versailles ;11;409;22;34;56;11;11;22;8998;13906;22904;4499
proces ;7;409;13;29;42;7;7;14;5317;11861;17178;2863
reconnu ;8;408;15;35;50;8;8;16;6120;14280;20400;3264
augmenter ;10;408;18;42;60;10;10;20;7344;17136;24480;4080
chercher ;9;408;13;41;54;9;9;18;5304;16728;22032;3672
jerusalem ;10;408;19;33;52;10;10;20;7752;13464;21216;4080
ennemi ;7;408;11;31;42;7;7;14;4488;12648;17136;2856
vendredi ;9;407;15;36;51;9;9;18;6105;14652;20757;3663
nucleaire ;10;407;17;35;52;10;10;20;6919;14245;21164;4070
photos ;7;406;14;37;51;7;7;14;5684;15022;20706;2842
covid ;6;406;10;23;33;6;6;12;4060;9338;13398;2436
bassin ;7;406;13;17;30;7;7;14;5278;6902;12180;2842
deplacer ;9;406;13;37;50;9;9;18;5278;15022;20300;3654
jusque ;7;406;15;28;43;7;7;14;6090;11368;17458;2842
europeennes ;12;406;22;59;81;12;12;24;8932;23954;32886;4872
remplacer ;10;405;17;38;55;10;10;20;6885;15390;22275;4050
alba ;5;405;6;12;18;5;5;10;2430;4860;7290;2025
declare ;8;404;11;29;40;8;8;16;4444;11716;16160;3232
empecher ;9;404;13;46;59;9;9;18;5252;18584;23836;3636
superieur ;10;404;22;34;56;10;10;20;8888;13736;22624;4040
aliments ;9;404;17;30;47;9;9;18;6868;12120;18988;3636
mille ;6;404;10;21;31;6;6;12;4040;8484;12524;2424
italienne ;10;404;17;36;53;10;10;20;6868;14544;21412;4040
suffit ;7;403;14;25;39;7;7;14;5642;10075;15717;2821
alimentation ;13;403;24;47;71;13;13;26;9672;18941;28613;5239
george ;7;403;10;37;47;7;7;14;4030;14911;18941;2821
portes ;7;403;15;28;43;7;7;14;6045;11284;17329;2821
dame ;5;403;6;19;25;5;5;10;2418;7657;10075;2015
peche ;6;403;7;34;41;6;6;12;2821;13702;16523;2418
puissant ;9;402;20;29;49;9;9;18;8040;11658;19698;3618
reaction ;9;401;16;31;47;9;9;18;6416;12431;18847;3609
devrait ;8;401;15;24;39;8;8;16;6015;9624;15639;3208
hongrie ;8;401;13;39;52;8;8;16;5213;15639;20852;3208
cent ;5;401;8;20;28;5;5;10;3208;8020;11228;2005
cherche ;8;401;10;40;50;8;8;16;4010;16040;20050;3208
conseils ;9;401;17;33;50;9;9;18;6817;13233;20050;3609
flotte ;7;401;13;31;44;7;7;14;5213;12431;17644;2807
affaire ;8;399;11;27;38;8;8;16;4389;10773;15162;3192
titres ;7;399;16;17;33;7;7;14;6384;6783;13167;2793
martin ;7;399;14;19;33;7;7;14;5586;7581;13167;2793
echange ;8;399;9;42;51;8;8;16;3591;16758;20349;3192
carbone ;8;399;12;30;42;8;8;16;4788;11970;16758;3192
envers ;7;398;14;27;41;7;7;14;5572;10746;16318;2786
domination ;11;398;20;44;64;11;11;22;7960;17512;25472;4378
tome ;5;397;9;22;31;5;5;10;3573;8734;12307;1985
relief ;7;397;11;26;37;7;7;14;4367;10322;14689;2779
instrument ;11;397;25;38;63;11;11;22;9925;15086;25011;4367
augmente ;9;397;15;41;56;9;9;18;5955;16277;22232;3573
sinon ;6;397;12;23;35;6;6;12;4764;9131;13895;2382
candidats ;10;397;16;31;47;10;10;20;6352;12307;18659;3970
concerne ;9;397;14;41;55;9;9;18;5558;16277;21835;3573
caractere ;10;396;16;30;46;10;10;20;6336;11880;18216;3960
endroits ;9;396;18;32;50;9;9;18;7128;12672;19800;3564
attendre ;9;395;16;33;49;9;9;18;6320;13035;19355;3555
spectacle ;10;395;16;40;56;10;10;20;6320;15800;22120;3950
vecu ;5;395;9;20;29;5;5;10;3555;7900;11455;1975
princesse ;10;395;19;37;56;10;10;20;7505;14615;22120;3950
souris ;7;395;17;18;35;7;7;14;6715;7110;13825;2765
portent ;8;394;17;35;52;8;8;16;6698;13790;20488;3152
augmentation ;13;394;24;54;78;13;13;26;9456;21276;30732;5122
berlin ;7;394;12;22;34;7;7;14;4728;8668;13396;2758
maritime ;9;394;17;25;42;9;9;18;6698;9850;16548;3546
definitivement ;15;394;27;62;89;15;15;30;10638;24428;35066;5910
impossible ;11;393;21;40;61;11;11;22;8253;15720;23973;4323
sociaux ;8;393;16;28;44;8;8;16;6288;11004;17292;3144
completement ;13;393;23;64;87;13;13;26;9039;25152;34191;5109
opera ;6;393;10;25;35;6;6;12;3930;9825;13755;2358
vetements ;10;393;20;43;63;10;10;20;7860;16899;24759;3930
seigneurs ;10;393;20;37;57;10;10;20;7860;14541;22401;3930
medecin ;8;393;11;34;45;8;8;16;4323;13362;17685;3144
materiel ;9;393;16;29;45;9;9;18;6288;11397;17685;3537
caracteristiques ;17;393;34;52;86;17;17;34;13362;20436;33798;6681
roches ;7;393;12;30;42;7;7;14;4716;11790;16506;2751
christ ;7;392;14;21;35;7;7;14;5488;8232;13720;2744
avais ;6;392;11;13;24;6;6;12;4312;5096;9408;2352
evenement ;10;392;17;50;67;10;10;20;6664;19600;26264;3920
attaques ;9;392;18;32;50;9;9;18;7056;12544;19600;3528
comte ;6;392;10;26;36;6;6;12;3920;10192;14112;2352
courte ;7;392;14;26;40;7;7;14;5488;10192;15680;2744
turcs ;6;391;14;15;29;6;6;12;5474;5865;11339;2346
bible ;6;391;8;18;26;6;6;12;3128;7038;10166;2346
predateurs ;11;391;22;39;61;11;11;22;8602;15249;23851;4301
gout ;5;391;10;23;33;5;5;10;3910;8993;12903;1955
voulait ;8;391;17;27;44;8;8;16;6647;10557;17204;3128
element ;8;391;13;37;50;8;8;16;5083;14467;19550;3128
changement ;11;390;16;56;72;11;11;22;6240;21840;28080;4290
reseaux ;8;390;16;29;45;8;8;16;6240;11310;17550;3120
categories ;11;390;19;41;60;11;11;22;7410;15990;23400;4290
fera ;5;390;7;17;24;5;5;10;2730;6630;9360;1950
midi ;5;389;8;13;21;5;5;10;3112;5057;8169;1945
willy ;6;389;13;24;37;6;6;12;5057;9336;14393;2334
cercle ;7;389;10;26;36;7;7;14;3890;10114;14004;2723
rose ;5;389;10;17;27;5;5;10;3890;6613;10503;1945
nommee ;7;388;11;36;47;7;7;14;4268;13968;18236;2716
ours ;5;388;12;15;27;5;5;10;4656;5820;10476;1940
peninsule ;10;388;19;44;63;10;10;20;7372;17072;24444;3880
christianisme ;14;388;27;44;71;14;14;28;10476;17072;27548;5432
prisonniers ;12;388;26;42;68;12;12;24;10088;16296;26384;4656
garder ;7;387;11;24;35;7;7;14;4257;9288;13545;2709
adresse ;8;387;14;25;39;8;8;16;5418;9675;15093;3096
suivi ;6;387;14;14;28;6;6;12;5418;5418;10836;2322
solution ;9;387;20;35;55;9;9;18;7740;13545;21285;3483
morte ;6;386;12;23;35;6;6;12;4632;8878;13510;2316
note ;5;386;9;23;32;5;5;10;3474;8878;12352;1930
rock ;5;385;9;16;25;5;5;10;3465;6160;9625;1925
garcons ;8;385;14;31;45;8;8;16;5390;11935;17325;3080
rive ;5;385;10;14;24;5;5;10;3850;5390;9240;1925
morceaux ;9;385;17;37;54;9;9;18;6545;14245;20790;3465
cinquieme ;10;384;17;43;60;10;10;20;6528;16512;23040;3840
organise ;9;384;16;34;50;9;9;18;6144;13056;19200;3456
inspire ;8;384;16;26;42;8;8;16;6144;9984;16128;3072
chant ;6;384;9;25;34;6;6;12;3456;9600;13056;2304
matieres ;9;383;17;27;44;9;9;18;6511;10341;16852;3447
nations ;8;383;16;28;44;8;8;16;6128;10724;16852;3064
telle ;6;383;10;24;34;6;6;12;3830;9192;13022;2298
absence ;8;382;11;30;41;8;8;16;4202;11460;15662;3056
hauts ;6;382;12;21;33;6;6;12;4584;8022;12606;2292
certaine ;9;382;15;30;45;9;9;18;5730;11460;17190;3438
disparition ;12;382;24;38;62;12;12;24;9168;14516;23684;4584
graines ;8;382;14;27;41;8;8;16;5348;10314;15662;3056
acteur ;7;381;13;21;34;7;7;14;4953;8001;12954;2667
gagne ;6;381;7;31;38;6;6;12;2667;11811;14478;2286
monuments ;10;381;21;45;66;10;10;20;8001;17145;25146;3810
diametre ;9;381;15;30;45;9;9;18;5715;11430;17145;3429
orleans ;8;381;15;29;44;8;8;16;5715;11049;16764;3048
connues ;8;381;15;36;51;8;8;16;5715;13716;19431;3048
limite ;7;381;13;21;34;7;7;14;4953;8001;12954;2667
reference ;10;380;15;44;59;10;10;20;5700;16720;22420;3800
alphabet ;9;380;13;38;51;9;9;18;4940;14440;19380;3420
reprendre ;10;380;18;41;59;10;10;20;6840;15580;22420;3800
offre ;6;380;9;29;38;6;6;12;3420;11020;14440;2280
commencent ;11;380;18;53;71;11;11;22;6840;20140;26980;4180
elevage ;8;380;11;38;49;8;8;16;4180;14440;18620;3040
memoire ;8;380;14;32;46;8;8;16;5320;12160;17480;3040
web ;4;380;6;16;22;4;4;8;2280;6080;8360;1520
archipel ;9;380;14;36;50;9;9;18;5320;13680;19000;3420
capables ;9;379;13;32;45;9;9;18;4927;12128;17055;3411
chretienne ;11;379;18;49;67;11;11;22;6822;18571;25393;4169
representent ;13;379;26;55;81;13;13;26;9854;20845;30699;4927
bacteries ;10;379;17;29;46;10;10;20;6443;10991;17434;3790
israel ;7;379;13;17;30;7;7;14;4927;6443;11370;2653
republicains ;13;379;24;43;67;13;13;26;9096;16297;25393;4927
cycle ;6;378;9;27;36;6;6;12;3402;10206;13608;2268
savant ;7;378;14;21;35;7;7;14;5292;7938;13230;2646
revenir ;8;378;16;27;43;8;8;16;6048;10206;16254;3024
visible ;8;378;15;23;38;8;8;16;5670;8694;14364;3024
redaction ;10;378;17;36;53;10;10;20;6426;13608;20034;3780
occupation ;11;378;20;47;67;11;11;22;7560;17766;25326;4158
propriete ;10;377;20;42;62;10;10;20;7540;15834;23374;3770
visite ;7;377;15;19;34;7;7;14;5655;7163;12818;2639
vii ;4;377;8;8;16;4;4;8;3016;3016;6032;1508
issue ;6;377;13;16;29;6;6;12;4901;6032;10933;2262
vaut ;5;377;11;15;26;5;5;10;4147;5655;9802;1885
pousse ;7;377;15;30;45;7;7;14;5655;11310;16965;2639
transports ;11;377;26;36;62;11;11;22;9802;13572;23374;4147
evenements ;11;376;20;52;72;11;11;22;7520;19552;27072;4136
messages ;9;376;16;34;50;9;9;18;6016;12784;18800;3384
devaient ;9;376;15;35;50;9;9;18;5640;13160;18800;3384
accepte ;8;376;11;34;45;8;8;16;4136;12784;16920;3008
ressources ;11;376;24;36;60;11;11;22;9024;13536;22560;4136
echelle ;8;376;10;40;50;8;8;16;3760;15040;18800;3008
capacite ;9;376;13;31;44;9;9;18;4888;11656;16544;3384
camps ;6;376;10;22;32;6;6;12;3760;8272;12032;2256
revenus ;8;375;17;31;48;8;8;16;6375;11625;18000;3000
chacune ;8;375;11;36;47;8;8;16;4125;13500;17625;3000
invente ;8;375;15;34;49;8;8;16;5625;12750;18375;3000
colonie ;8;375;13;36;49;8;8;16;4875;13500;18375;3000
utile ;6;375;12;19;31;6;6;12;4500;7125;11625;2250
tourne ;7;375;15;28;43;7;7;14;5625;10500;16125;2625
chimique ;9;375;15;40;55;9;9;18;5625;15000;20625;3375
malade ;7;374;9;25;34;7;7;14;3366;9350;12716;2618
auparavant ;11;374;21;36;57;11;11;22;7854;13464;21318;4114
douze ;6;374;11;32;43;6;6;12;4114;11968;16082;2244
windows ;8;373;17;34;51;8;8;16;6341;12682;19023;2984
frederic ;9;373;14;32;46;9;9;18;5222;11936;17158;3357
quitter ;8;372;18;28;46;8;8;16;6696;10416;17112;2976
flandre ;8;372;12;32;44;8;8;16;4464;11904;16368;2976
arabes ;7;372;11;17;28;7;7;14;4092;6324;10416;2604
echec ;6;372;6;30;36;6;6;12;2232;11160;13392;2232
croissance ;11;372;20;36;56;11;11;22;7440;13392;20832;4092
bronze ;7;372;13;33;46;7;7;14;4836;12276;17112;2604
vide ;5;371;8;18;26;5;5;10;2968;6678;9646;1855
patrimoine ;11;371;21;41;62;11;11;22;7791;15211;23002;4081
invasion ;9;371;18;31;49;9;9;18;6678;11501;18179;3339
observer ;9;371;18;32;50;9;9;18;6678;11872;18550;3339
buts ;5;371;11;13;24;5;5;10;4081;4823;8904;1855
nez ;4;371;7;22;29;4;4;8;2597;8162;10759;1484
drapeau ;8;371;13;29;42;8;8;16;4823;10759;15582;2968
participe ;10;370;18;35;53;10;10;20;6660;12950;19610;3700
wikipedia ;10;370;17;34;51;10;10;20;6290;12580;18870;3700
duche ;6;370;8;29;37;6;6;12;2960;10730;13690;2220
violence ;9;369;15;40;55;9;9;18;5535;14760;20295;3321
voitures ;9;369;21;30;51;9;9;18;7749;11070;18819;3321
parle ;6;369;10;22;32;6;6;12;3690;8118;11808;2214
fruit ;6;369;13;17;30;6;6;12;4797;6273;11070;2214
auraient ;9;369;17;26;43;9;9;18;6273;9594;15867;3321
regle ;6;369;9;26;35;6;6;12;3321;9594;12915;2214
lycee ;6;369;9;29;38;6;6;12;3321;10701;14022;2214
periodes ;9;369;16;37;53;9;9;18;5904;13653;19557;3321
disponible ;11;368;19;44;63;11;11;22;6992;16192;23184;4048
roche ;6;368;9;28;37;6;6;12;3312;10304;13616;2208
attaquer ;9;368;18;31;49;9;9;18;6624;11408;18032;3312
traverse ;9;368;19;27;46;9;9;18;6992;9936;16928;3312
presenter ;10;368;20;40;60;10;10;20;7360;14720;22080;3680
projets ;8;368;17;30;47;8;8;16;6256;11040;17296;2944
depend ;7;367;9;37;46;7;7;14;3303;13579;16882;2569
tenir ;6;367;12;18;30;6;6;12;4404;6606;11010;2202
envoye ;7;367;13;39;52;7;7;14;4771;14313;19084;2569
directeur ;10;367;19;32;51;10;10;20;6973;11744;18717;3670
lion ;5;367;9;19;28;5;5;10;3303;6973;10276;1835
capitaine ;10;367;16;34;50;10;10;20;5872;12478;18350;3670
complexe ;9;367;15;48;63;9;9;18;5505;17616;23121;3303
expliquer ;10;366;20;47;67;10;10;20;7320;17202;24522;3660
differente ;11;366;17;49;66;11;11;22;6222;17934;24156;4026
mourir ;7;366;16;20;36;7;7;14;5856;7320;13176;2562
revolte ;8;366;16;33;49;8;8;16;5856;12078;17934;2928
generaux ;9;366;16;41;57;9;9;18;5856;15006;20862;3294
marseille ;10;366;18;32;50;10;10;20;6588;11712;18300;3660
discours ;9;365;19;27;46;9;9;18;6935;9855;16790;3285
reduire ;8;365;15;25;40;8;8;16;5475;9125;14600;2920
arriver ;8;365;17;18;35;8;8;16;6205;6570;12775;2920
tellement ;10;365;18;44;62;10;10;20;6570;16060;22630;3650
economiques ;12;365;22;58;80;12;12;24;8030;21170;29200;4380
echapper ;9;365;13;45;58;9;9;18;4745;16425;21170;3285
populaires ;11;365;22;44;66;11;11;22;8030;16060;24090;4015
artiste ;8;365;17;19;36;8;8;16;6205;6935;13140;2920
petrole ;8;365;15;36;51;8;8;16;5475;13140;18615;2920
representants ;14;365;29;53;82;14;14;28;10585;19345;29930;5110
contributions ;14;365;30;49;79;14;14;28;10950;17885;28835;5110
hautes ;7;364;13;27;40;7;7;14;4732;9828;14560;2548
www ;4;364;10;19;29;4;4;8;3640;6916;10556;1456
james ;6;364;10;18;28;6;6;12;3640;6552;10192;2184
million ;8;363;15;29;44;8;8;16;5445;10527;15972;2904
utilisant ;10;363;22;27;49;10;10;20;7986;9801;17787;3630
normalement ;12;363;22;52;74;12;12;24;7986;18876;26862;4356
dizaines ;9;363;16;33;49;9;9;18;5808;11979;17787;3267
quartiers ;10;363;22;30;52;10;10;20;7986;10890;18876;3630
georges ;8;362;13;39;52;8;8;16;4706;14118;18824;2896
organiser ;10;362;19;35;54;10;10;20;6878;12670;19548;3620
euro ;5;362;10;19;29;5;5;10;3620;6878;10498;1810
primaire ;9;362;17;26;43;9;9;18;6154;9412;15566;3258
peintre ;8;362;15;32;47;8;8;16;5430;11584;17014;2896
cap ;4;362;5;15;20;4;4;8;1810;5430;7240;1448
bonnes ;7;362;12;31;43;7;7;14;4344;11222;15566;2534
sauver ;7;361;15;21;36;7;7;14;5415;7581;12996;2527
anniversaire ;13;361;25;40;65;13;13;26;9025;14440;23465;4693
difficiles ;11;361;17;39;56;11;11;22;6137;14079;20216;3971
arrivent ;9;361;19;26;45;9;9;18;6859;9386;16245;3249
bouche ;7;361;10;34;44;7;7;14;3610;12274;15884;2527
pate ;5;361;8;20;28;5;5;10;2888;7220;10108;1805
modernes ;9;361;16;39;55;9;9;18;5776;14079;19855;3249
vin ;4;361;8;13;21;4;4;8;2888;4693;7581;1444
antoine ;8;361;14;32;46;8;8;16;5054;11552;16606;2888
sicile ;7;361;12;19;31;7;7;14;4332;6859;11191;2527
coreen ;7;361;11;31;42;7;7;14;3971;11191;15162;2527
crees ;6;360;10;20;30;6;6;12;3600;7200;10800;2160
social ;7;360;12;21;33;7;7;14;4320;7560;11880;2520
sel ;4;360;7;13;20;4;4;8;2520;4680;7200;1440
decrit ;7;360;12;21;33;7;7;14;4320;7560;11880;2520
sommes ;7;360;14;28;42;7;7;14;5040;10080;15120;2520
modifications ;14;360;25;52;77;14;14;28;9000;18720;27720;5040
journaliste ;12;359;25;39;64;12;12;24;8975;14001;22976;4308
accueil ;8;359;12;26;38;8;8;16;4308;9334;13642;2872
champ ;6;359;8;29;37;6;6;12;2872;10411;13283;2154
civilisation ;13;359;26;38;64;13;13;26;9334;13642;22976;4667
ceremonie ;10;358;16;43;59;10;10;20;5728;15394;21122;3580
necessaires ;12;358;22;39;61;12;12;24;7876;13962;21838;4296
residence ;10;358;16;38;54;10;10;20;5728;13604;19332;3580
byzantin ;9;358;18;39;57;9;9;18;6444;13962;20406;3222
accueillir ;11;357;19;32;51;11;11;22;6783;11424;18207;3927
erreur ;7;357;15;20;35;7;7;14;5355;7140;12495;2499
compter ;8;357;15;35;50;8;8;16;5355;12495;17850;2856
sultan ;7;357;15;22;37;7;7;14;5355;7854;13209;2499
viii ;5;357;10;9;19;5;5;10;3570;3213;6783;1785
architecte ;11;357;18;40;58;11;11;22;6426;14280;20706;3927
menace ;7;357;9;30;39;7;7;14;3213;10710;13923;2499
